предложить дт| предложить  Вам
пользоваться тв| пользуется  большим  успехом
посылать вн| Посылаю книгу "Семь дней творения"  Иллюстрации
быть им| -Тарханов Михаил Иванович
секретарить рд| Секретарь Союза художников России
предусмотреть тв| предусмотренного   договором  с  Федеральным  агентством по печати
являться тв| является  посредником
установить рд| установленных сборов
составить вн| на расчетном счете Фонда на  01 января 2007 г.  составил одну тысячу
быть тв| учредителем  была
поступить рд| Фонда поступило
закончен рд| телефона закончена
сообщить рд| 13 марта 1998    МК   сообщил
делать вн| делает чистую работу
умудрить тв| умудренный  опытом
отяготить тв| отягощенный знанием, пошатавшийся
казаться рд| казалось им
казаться тв| казалось им
казаться дт| казалось им
представляться тв| представляется простейшей вещью на свете
благословлён тв| благословлен туевой кучей штук
видеть рд| видели резона
решить тв| большинством  голосов  решили  немедленно
решить рд| голосов  решили  немедленно
замереть пр| замерла воздухе
быть рд| вода была
пронзить рд| луча  пронзили толщу  воды
пронзить вн| пронзили толщу
всеять тв| всей кодлой
торчать тв| торчавшей  нелепой луковицей  над  носом судна
опустеть дт| опустевшую банку на самые       хрупкие инструменты
махнуть тв| махнул рукой
говорить дт| вам говорили
обменяться тв| обменялся скучающим взглядом
запричитать тв| хором запричитали
прийтись дт| вам   пришлось
пойти тв| пойти  окольным  путем
достигнуть рд| достигшая   критической   массы
ткнуть тв| ткнул  пальцем  в  графики на дисплее
не говорите дт| ему  не  говорили
нравиться дт| нам нравится
напоминать дт| вам напоминать
заниматься тв| этим заниматься
снимать тв| этим снимает с себя всю ответственность
проступать рд| океанского  дна  проступал  вдалеке все
вместить рд| дабы   вместить   грузовые    отсеки
защитить тв| защищенные  ультра-сталью
долбить тв| долбили  тараном
подвергать дт| подвергали всем видам
оставаться тв| остаются непроницаемыми
рвать вн| рванную трещину в  обшивке
замельтешить тв| замельтешили фонариками
прийтись тв| Им пришлось
пройти рд| пройти несколько титановых дверей
прийтись рд| Им пришлось
открывать тв| открывали  кварковыми   ключами
вылупиться тв| фонариком  вылупившееся на него
уменьшить вн| уменьшенную квинту
поменяться тв| поменялся  шлемами  с пустым
спереть рд1| спертого корабельного воздуха
гнить дт| гниющим останкам
сойти рд| сошел с ума
стоять рд| стоят долгого пути
сделать вн| сделал эффектную  паузу
вращать тв| вращать глазами
плавать тв| потом плавать
послать тв| послал SOS, а потом
скрючить тв| скрюченными пальцами по стеклу  резервуара
использовать рд| аориста использовали  в  старые добрые
качать вн| качать  энергию  из  прошлого
сопровождаться тв| сопровождаются приливом крови к  голове
усеян рд| прошлого были усеяны
усеян тв| усеяны  скважинами  для  генерирования  дармовой бесполезной энергии
предоставлять вн| предоставляло дешевую, чистую  энергию
пробурить вн| пробуривших гадскую уйму скважин
пожать тв| пожал плечами
есть пр| корабле  есть вещи
считать тв| считать его параноиком
залить тв| залитым желудочным соком
отравить вн| отравить целую планету
взорвать вн| взорвать целую планету
облучить вн| облучить целую планету
бояться рд| нечего  бояться
покрыт тв| покрыт осколками
сорвать рд| сорвала сила
смерить тв| спокойно смерил Зафода взглядом
получить рд| Сириуса  получила
оказаться тв| оказались  сплавом  характеристик
стать тв| стали горестными  неудачниками
активировать вн| активировали внутреннюю сигнализацию
позволить дт| им позволят
позволить тв| им позволят
позволить рд| им позволят
наполнить тв| наполненном густой  желтой  жидкостью
улыбаться дт| мирно и тихо улыбался самому себе
вычислить вн| вычислили планету
вычислить дт| вычислили планету
полниться рд| планета  полнилась
озлобить тв| озлобленными  людьми
скрашивать дт| скрашивали им
скрашивать рд| скрашивали им
скрашивать тв| скрашивали им
приколотить тв| после  того, как одного человека приколотили гвоздями к  дереву
сделать тв| сделать обителью
прочить дт| прочим предметам
прочим дт| прочим предметам
собираться дт| собираюсь вам
выведен тв| крупными  буквами  выведены
быть дт| Артуру было столько
лить тв| ночью лил
обойти вн| обошел  комнату
отразить тв| отразило  второй
отразить вн| отразило щетину
заметить рд| тут  заметил  в  зеркале  какое-
бить тв| неоднократно битый жизнью
убрать рд| до конца дня убрать с дороги дом
смять вн| смяв  свою  меховую шапку
возить тв| возя ею
потрясти тв| угрожающе потряс пальцем, потом
отвести вн| отвел руку
мчаться дт| одним  индивидам  мчаться сломя
побрать рд| черт побери
скрещенный тв| скрещенными  топорами  над  входной  дверью (его жена, разумеется, отдавала  предпочтение  вьющимся  розам,  но  мистер Проссер настаивал на топорах - почему - он не знал,  просто  топоры  ему нравились)
налиться тв| налился краской
проявлять вн| проявлял    вопиющую  некомпетентность
сказать тв| потом сказал
запереть пр1| На дне запертого
заколотить пр| заколоченном  туалете
подпереть вн| подперев голову
понравиться дт| Вам понравится
объять тв| объятых пламенем  развалин
притворяться тв| вполне  правдоподобно  притворялся безработным актером
впиться дт| вопьется вам
первый попавшийся тв| первым попавшимся астрофизиком до тех пор
вышвыривать рд| вышвыривали вон
овладевать тв| им овладевали
овладевать дт| им овладевали
овладевать рд| им овладевали
разражаться тв| разражался диким  хохотом
заплетаться тв| заплетающимся  языком
иметь рд| имеет  решающего значения
выспрашивать вн| выспрашивая дорогу на Бетельгейзе
отправиться дт| вам отправиться домой
путешествовать тв| путешествовать автостопом
надлежать дт| Артуру  надлежало
требовать вн| периодически требовать адвоката, маму или  хорошую  книжку
извлечь рд| дабы  извлечь  из  ситуации  наибольшую  материальную  выгоду
повернуть вн| повернул голову
ведать рд| ведают  сарказма
выразить рд| Форда выразило
хотеть дт| хочу ему
сообщить вн| сообщить самую важную вещь  в  твоей  жизни
играть вн| играть  в  одну  старинную  игру
помять вн| Помните  бессмертную  древнюю песню
помнить вн| Помните  бессмертную  древнюю песню
наливаться тв| свинцом наливается
загораться тв| огнем загорается
пытаться тв| пытаются усилием воли
наклонить вн| наклонить бутылку
ставить вн| Потом ставят новую бутылку
улыбнуться тв| потом  улыбнулся
схватить вн| одновременно,  потом  схватил  свою  меховую шапку
оставаться дт| Ему  оставалось
стоить дт| Стоило мистеру
стоять дт| Стоило мистеру
сделать рд| сделал несколько неуверенных шажков
лечь дт| Дай  человеку лечь
дать дт| Дай  человеку
махнуть дт| махнул мистеру Проссеру
совершить вн| Совершил посадку
принести тв| принесло им
принести дт| принесло им
принести рд| принесло им
лучить рд1| по тонкому лучу света
воспользоваться тв| воспользуетесь отчетом  последней  Всегалактической  переписи
съесть вн| съела кучу
сообщить дт| сообщила никому
отправлен рд| от греха подальше  отправлены в мусорную корзину
окутать тв| окутанный  симпатичным  радужным облаком
появиться рд1| света появилась
помахать тв| неуклюже помахал  рукой
руководствоваться тв| руководствуясь  внезапным  наитием
владеть тв| владеет  центаврийской  азбукой:  "БЕСПОШЛИННО.  МЕГАМАРКЕТ.  ПОРТ  БРАСТА,   АЛЬФА  ЦЕНТАВРА. БУДЬ, КАК ДВАДЦАТЬ ВТОРОЙ СЛОН С  РАЗДУТОЙ  ЭКОНОМОСТОИМОСТЬЮ  В  КОСМОСЕ - ГАВ!"     -
подождать тв| центаврийской  азбукой:  "БЕСПОШЛИННО.  МЕГАМАРКЕТ.  ПОРТ  БРАСТА,   АЛЬФА  ЦЕНТАВРА. БУДЬ, КАК ДВАДЦАТЬ ВТОРОЙ СЛОН С  РАЗДУТОЙ  ЭКОНОМОСТОИМОСТЬЮ  В  КОСМОСЕ - ГАВ!"     - Подождите
всплеснуть тв| всплеснув руками
спустить рд| секунд спустя
вжимать вн| вжимал  голову  в  плечи  под  напором
направиться тв| ,  ускорив  шаг, направился прямиком к той точке на горизонте
осмотреть вн| осмотрел  преграду
сверкнуть тв| сверкнув фарами  сквозь  водяную  стену
обдать тв| обдало  водой
вымокнуть дт| насквозь вымокшему пришельцу за какую-
прочитать вн| долю секунды  прочитать  наклейку  на бампере
продолжить вн| продолжил беседу
промчаться тв| Роб  Маккенна, молнией промчавшись
написать вн| написавшего эту статью
дёргать вн| дергал свою многострадальную судьбу за хвост
освоить пр1| в одном уголке освоенной
вылетать тв| ласковым   мурлыканьем   вылетает   из   шахты    межзвездная  баллистическая ракета
барабанить тв| барабанила  пальцами по стойке
украшать тв| украшая ее цепочками вмятин
коснуться рд| легонько коснулся  плеча Форда Префекта
заставить рд| заставило Форда
крепиться тв| крепилась  суставами
завещать вн| неожиданно завещал  свою  руку  на нужды Академии медицины
прочуять вн| прочую чертовщину
распознавать рд| распознавать  с  первого  взгляда
ошарашить тв| несколько ошарашенным видом
изобрести тв| изобретенный человеком
рвать рд| Форда  рвал
рвать дт| рвал  бармену
затрещать рд| Форда  затрещали
обучаться дт| обучалась  болевым  приемам
перепихнуть вн| перепихнул карточку через стойку к Форду
приобрести вн| за серьезной ошибки компьютера Форд приобрел кредитную карточку
хранить вн| бережно хранил кредитную карточку  "Америкэн  экспресс"
обвести тв| обвел взглядом
служить рд| служащих  фирм
прорезать вн| прорезали кромешную тьму бара
прорезать тв| порой прорезали кромешную тьму бара
прервать рд| нити прерванных разговоров о контрактах  на  убийства,  поставки  наркотиков
растерять вн| растерять аппетит и жажду
взять вн| взял бумажку
царапать тв| царапала когтями
выдуть вн| выдул целую реку всякой бодрящей фигни с пузырьками
случиться рд| счета случился
положить вн| положил  левую  ладонь  на  свой полурасстегнутый
нарушить рд| нарушил  законов
ослабить вн| медленно ослабила хватку
пересохнуть тв| пересохшими  губами
проводить вн| проводит ревизию и обновление
провозить вн| проводит ревизию и обновление  информации
захотеться рд| им  захочется
захотеться тв| им  захочется
захотеться дт| им  захочется
водить вн| водить машину
показывать дт| показывать его людям
превосходить рд| замечательных  жизнетворных  питательных  веществ  превосходит
почувствовать тв| почувствовал собственными ногами
уничтожить вн| Землю уничтожили окончательно  и  бесповоротно
приносить вн| Рону                                  Приношу глубокую  благодарность
становиться тв| становятся  причиной  других  случайностей
подчиняться дт| подчиняются собственным законам
населять вн| Поэтому  населяющие  Галактику  расы
позаботиться тв| позаботились веками
пролететь рд| пролетели  пол-Галактики
покинуть тв| Покинутая  командой
оставлен тв| оставлена командой
выйти рд| 16 октября  вышла  из Бостона, направляясь в Лисабон
пропускать вн| пропускал воду
пропускать дт| пропускал воду
благоприятствовать дт| благоприятствовала плаванию  бригантины
привести вн| привести следующую деталь: на швейной машине лежала катушка шелковых  ниток, которая даже при небольшой качке, конечно, скатилась бы на пол.     Все лодки оказались целыми и висели на своих местах, на шлюп-балках,  а  груз - свечное сало и американские часы - сохранился в неприкосновенности.  На баке, среди различного хлама, обнаружен старинный меч искусной  работы.  На его стальном клинке виднеются какие-то продольные полосы, словно меч не  так давно вытирали. Оружие было доставлено в полицию, которая передала его  для  исследования  доктору  Монегену.  Результаты  исследования  пока   не  известны.     В заключение  отметим,  что,  по  мнению  капитана  "Божьей  благодати"  Дальтона - опытного и сведущего моряка, -
тереть вн| три  пассажира,  в  том  числе
разгадать вн| разгадать эту  тайну
удаться дт| удалось  никому
выступить пр| долгом выступить с этим сообщением
знать вн| знали мою безупречную честность
противоречить дт| противоречить  сумасшедшему
деть дт| дело  забвению
тереть рд| три факта
выпускать рд1| выпускаемого пара
испытывать вн| испытывал странную грусть
быть пр| море было
проклясть рд| проклятого корабля
щёлкнуть тв| щелкнув крышкой своего  хронометра
послышаться рд| с капитанского мостика послышался
вспенивать вн| вспенивая  воду
вспенивать дт| вспенивая  воду
мыть пр| моем маленьком антропологическом  музее
моем пр| моем маленьком антропологическом  музее
представлять тв| представлявших собой
обогнуть вн| обогнул эту груду
назвать тв| назвали  Мюллером
затянуться тв| и несколько  раз подряд яростно затянулся сигарой
поглощён тв| так поглощены  своим  делом
стоять тв| Стоило  им
стоить тв| Стоило  им
стоить рд| Стоило  им
овладеть тв| мною овладело
обить тв| обитый медью
припасть тв| припал глазом  к отверстию
произнести тв| зловещим смехом  произнес
рассмеяться тв| вновь рассмеялись холодным, резким смехом
оковать тв| окованный  медью
вывести вн| меня вывел голос нашего милейшего
обладать тв| обладал  достаточным  мужеством
улечься пр1| улегся на дне
попадать рд| моего  зрения попадала
подслушать тв| подслушанный мною
проанализировать вн| проанализировал различные факты, из  которых
избежать рд| избежав осмотра  багажа  в  таможне
применять вн| применяли заговорщическую тактику
соединяться рд| недостатка соединяются
отличаться тв| при этом отличались  мужеством
выступить тв| выступить доносчиком в очной  ставке
мыть зв| Боже мой
рассказать дт| рассказать ему
подсказать тв| здравым  смыслом подскажет
хотеть вн| Хочешь сигару
собрать тв| собранных  мною
жертвовать тв| жертвовать своей жизнью
показаться тв| показаться торпедой
выкурить вн| уже выкурил сигару
распить вн| разопьем бутылочку красного вина
наблюдать тв| ними наблюдают
толкнуть тв| толкнул Дика  локтем
увенчаться тв| увенчались успехом
восхищаться тв| восхищаться  самообладанием,  с
скрывать вн| скрывая   свою   страшную   тайну
истерзать тв| истерзанное бурей
различать вн| изредка  различал зеленоватую полоску
переломиться пр| переломилась футах
терять вн| на своем барке  не раз теряли надежду
увидеть вн| вновь увидеть землю
пережить вн| пережить  эту бурю
пожертвовать дт| пожертвовали урагану
ослепить тв| ослепленному  молнией
записать рд| волнений  записал  в  свой   дневник  следующие строки:     "Солнечная  система,  среди  других   бесчисленных   обширных   систем,  совершает  в  безмолвном  пространстве  свой  вечный  путь   к   созвездию  Геркулеса.  Безостановочно  и  бесшумно  вращаются,  кружатся  в  извечной  пустоте гигантские шары, из которых она состоит. В этой системе  одним  из  самых маленьких  и  незначительных  шаров  является  скопление  твердых  и  жидких, частиц, которое мы называем Землей. Вращаясь, она несется  вперед,  как неслась до моего рождения и как будет нестись  после  моей  смерти,  -  кружащаяся тайна, неведомо откуда пришедшая и неведомо куда убегающая.  На  поверхности этой движущейся массы копошатся бесчисленные  микроскопические  существа, и одно из них - это я, Джон Мак-Витти, беспомощный,  бессильный,  бесцельно увлекаемый в пространстве. И, однако, наша жизнь такова,  что  я  вынужден отдавать труду все свои слабые силы  и  проблески  разума,  чтобы  получать за это известные металлические кружки, покупать на них химические  элементы для питания моих  постоянно  разрушающихся  тканей  и  иметь  над  головой крышу для защиты от непогоды. Поэтому у меня не  остается  времени  для  размышления  над  мировыми  вопросами,  с  которыми  мне   приходится  сталкиваться на каждом шагу. Но при всем своем ничтожестве по  временам  я  все еще в состоянии чувствовать себя до известной  степени  счастливым,  а  иногда даже  -  как  ни  странно!  -  упиваться  сознанием  значительности  собственной персоны"
вызван тв| вызваны минутными
преходить тв| преходящими  эмоциями
возбудить рд| возбудили   судебного  преследования
прокоптить тв| прокопченным городишком
обрести вн| обрести покой и подходящую обстановку для  научных  занятий
уединить рд| уединенных  размышлений
стоять пр| участке  стоял
обнажить рд| обнаженных  холма
уединить пр| в своем  уединенном  кабинете  в  Мэнси
основан рд| Дальтона основана на недоразумении
занят тв| занят  своими  дистилляциями  и  анализами
подавать рд| часов  подавала
обнаруживать рд| золота обнаруживают
получить вн| получил широкую известность
закончиться тв| за испанское наследство закончилась Утрехтским  миром
позволять дт| позволяла ему
прикреплять рд| корабля прикрепляли  блоки  и  тали
кружить вн| кружили  голову
греметь тв| гремя саблями
отрубить вн| отрубил голову
закопать вн| закопать свою долю
награбить рд| награбленного добра
обеспечивать тв| обеспечивали его провизией
жить тв| жило надеждой
раздробить дт| раздробили ему
охотиться тв| матросами  охотился
питать вн| из  них  питали непримиримую, кровавую вражду к Шарки
свихнуться дт| тому назад  свихнувшийся с пути истинного
доказывать тв| своими дурными делами доказывал
унаследовать тв| унаследованной  им
унаследовать дт| унаследованной  им
предаваться дт| предавался  пороку
дать вн| дал  взятку
доставить дт| с ним доставят вам
искупить тв| желанием искупить  свое  прошлое
пылать тв| в самом деле пылает желанием
принадлежать дт| принадлежал мистеру Кодрингтону и был
попасть дт| попадет нам
закрасить вн| закрашу полосу на "Белой розе" и во всем
подогнать пр| остальном подгоню  ее
показаться дт| губернатору показалось
прийти тв| им пришли
прийти дт| им пришли
писать рд| писали  мемуаров
оставить рд| оставили  никаких  следов
запятнать тв| запятнанных кровью
окутывать вн| окутывающую их завесу
состоять тв| состоял членом городского совета
приходиться тв| приходился  двоюродным  братом
погибнуть тв| погибла ужасной смертью
услыхать вн| Услыхав эту горестную весть, Копли Бэнкс
пыхтеть тв| пыхтел своей трубкой
пошатнуть пр| горе пошатнуло его
возить вн| теперь водил  дружбу
гореть дт| горящему кораблю
зарезать рд| зарезанной  им  овцы
подтверждаться тв| подтверждались моряками  торгового  судна
заключить дт| заключенного инспектору
рассказать вн| рассказал эту свою историю
докладывать дт| судьям докладывал все, как
видеть тв| своими глазами видел
разузнать тв| стороной разузнать
исправлен тв| умением  исправлена
предложить рд| ничего предложить
гнить пр| вине  гниет в тюрьме
уважить вн| уважите мою  просьбу
не говорите рд| ничего не говорю
доложить дт| доложу вам
избегать рд| избегать глухих мест по пути
доставать вн| очень  трудно  доставать работу
закрывать вн| закрывать торговлю
звать тв| Алленом его звали
течь рд| текущие счета
позвать рд| Тут позвала
сбит тв| Сбит человек с ног  потоком
нести тв| несет его водою
выплыть дт| выплыть ему
оказаться рд| парка оказались
оказаться рд1| парка оказались
усыпать тв| усыпанной песком площадки перед  крыльцом
зазвонить тв| зазвонила своей цепью
наметить дт| намеченному окну
взяться рд| злого умысла возьмешься за дверную ручку, а дверь-
отодвинуть тв| легко отодвинул ножом
приоткрыть вн| Приоткрыв раму
толкнуть вн| толкнул  ставню
толкнуть дт| толкнул  ставню
распахнуться тв| распахнувшейся ставней
зажечь тв| зажженной восковой  свечкой  в  руке
отпирать вн| отпирал  задвижку
засверкать тв| засверкав своими черными глазами
поверить дт| что  поверить  им
поверить тв| что  поверить  им
поверить рд| что  поверить  им
отплатить дт| отплатить своему мужу
хотеться дт| хотелось  по  самому  больному  месту
осветить тв| освещенное восковой свечечкой
дойти рд| дошли до конца комнаты
обвешан тв| обвешана занавесками с картинами
помешать дт| помешать ему
соблазнять тв| соблазняя  деньгами
попасться дт| самому попасться
переменить тв| Мигом переменила
начать рд| начнете  с этого конца
ломать рд| ломать  замков
раскрасить вн| раскрашенную  занавеску на стене
увидеть тв| Потом увидел
откинуть вн| откинул голову
забыть рд| забыла еще своей науки
протянуть вн| с женской хитростью протянула свою свечу
взять тв| рукой взяла
клясться дт| клянусь вам
поставить вн| поставил  свечу  на  угол стола
называть тв| называл Эдуардом
хлестать тв| плетью хлестали
отвечать дт| ему  отвечала
смолкнуть тв| потом смолкла
видать дт| веку видать
видеть пр1| доме видел
надевать вн| на шею надевает
просверлить вн| голову  так  и  просверлило
замелькать тв| Мигом  замелькали
поднять вн| подняла руку:       "Не трогайте его! Закон и без нас его накажет"
ударить тв| дважды  ударил  мужа  ножом
убит тв| убит своей женой
предан дт| вам предан
деть пр| простое дело
распоряжаться тв| распоряжается деньгами
осознать вн| осознать всю ошибочность
присылать вн| присылали связку
снимать вн| снимал квартиру в Гроувнор-мэншенс
чувствовать вн| Остро чувствовать нищету
насытить тв| насыщенных  всевозможными приключениями
отправиться тв| вечером того же дня отправился в Клиптон-
отправиться рд| вечером того же дня отправился в Клиптон-
забросить рд| заброшенного  полустанка
порасти тв| поросших  травой   холмов
расхваливать вн| всю дорогу  расхваливал
выходить дт| словам  выходило
жалеть рд| жалел денег
миновать рд| Когда  мы  миновали  ворота
греть рд| ворота  Грей-
выглядеть тв| выглядел  настоящим плантатором
дорожить тв| слишком дорожил знакомством с  богатым родственником
ответить тв| ответить  взаимностью на безграничное расположение
сообщать дт| сообщать  ему
наслаждаться тв| потом  наслаждались  гаванскими  сигарами  и  кофе, собранным
клокотать рд| клокочущего темперамента
покинуть вн| ненадолго  покинул комнату
злоупотреблять тв| что  я  злоупотребляю его радушием
понять рд| наших  лиц  понял
ошибиться тв| ошиблись номером
потерпеть рд| потерплю этого
послать вн| минуту  пошлите  за  управляющим  вашей  бездарной телефонной лавочки
быть зв| передо мной был разъяренный  лев
платить дт| этим  негодяям  деньги  платят
излагать вн| излагал  им  свою  вполне справедливую жалобу
излагать тв| излагал  им
излагать дт| излагал  им
излагать рд| излагал  им
докучать рд| дабы докучать
довершить рд| довершить бедствия  злополучного  утра
извлечь вн| наконец  извлекли  оттуда  газетную вырезку
обратить вн| обратило  зиму в лето
мыть тв| Дорогой мой
зачитать дт| зачитать  вам
прочесть дт| прочту вам
изобрести вн| изобрел  машину
дезинтегрировать тв| дезинтегрировать любой
надлежать рд| социального  и  политического  свойства надлежит
составить рд| составит труда
получить тв| полученные мною
ограничить тв| ограниченными способностями
лишён рд| лишены природного  ума
блестеть пр| блестящих  цилиндрах
недоделать вн| недоделанную клецку
упустить вн| упустило  свою  империю
винить дт| винить вам
назначить тв| назначенную мною
защищён пр| защищен кое-
содержать тв| со всем его содержимым
исказиться пр| лице исказилась
обсуждать вн| обсуждать  саму  проблему
представить дт| представить  нам
приложить вн| Приложите  эту  силу  в  большем  масштабе
увидеть дт| нам увидеть
испытать вн| испытаете  ее  работу
предоставить дт| что предоставлю вам
проявить вн| полную возможность проявить
мочь рд| нашего  тела  может  рассеять
разрывать рд| разрывающая сила
сказать дт| сказать вам
воссоздавать вн| вновь  воссоздают  структуру
смениться тв| вскоре сменятся совсем иными чувствами
помочь дт| поможет вам
уразуметь вн| уразуметь  мою  идею
предстоять дт| нам  предстоит
свисать рд| свисавшими  с  потолка  в  виде  гирлянд
находиться рд1| сбоку  находился своего рода
пронумеровать тв| пронумерованными  прорезями
покрыть тв| покрытой  резиною
бросить дт| брошенный  его  достоинству
гарантировать вн| гарантировать  вашу  безопасность
привлечь рд| этого  субъекта  привлекут  к  ответственности  за  человекоубийство
дрожать тв| под локоть дрожащей рукой
предлагать вн| ему предлагали кафедру в университете
предлагать дт| ему предлагали
бросить вн| вдруг  бросил и ботанику, и зоологию
погрузиться тв| со  всей  страстью  ученого  погрузился  в  изучение химии
избран тв| избран членом Королевского общества
рассказывать дт| вам рассказываю
волновать рд| что  так  волновало этого
заявить дт| заявить  читателям
хотеть рд| с  самого  начала  хочу  заявить  читателям
вызывать рд| вызывать сомнений
найден рд| Армстронга были найдены в поле
показать дт| показал  его  доктору  Дж
передать дт| передать  специалистам для изучения
мешать дт| мешает пониманию
отсутствовать пр| отсутствующих начальных страницах
дать рд| этих качеств дало
испытать рд| испытать  несколько  новых  авиационных  приборов
нацарапан тв| нацарапаны  карандашом
набросать тв| торопливо  набросанное авиатором
лететь пр| летящем  аэроплане
есть рд| блокнота есть несколько пятен
вооружать тв| вооружает  своими знаниями наших исследователей
считать вн| считал   привычку
достигать рд| достигали куда более значительных высот
использоваться тв| лошадиными  силами использовался для любой цели, возможности  полетов  были
испытывать рд| испытывая неприятных  ощущений
случиться дт| ему случится
наслать вн| его  машину  нашли неподалеку от Байонны, а бот сам
набрать вн| набравшая  огромную  высоту
вздёрнуться тв| рывками  вздернулась вертикально вверх
узнать рд| ничего  узнать
вдавить вн| в  состоянии  вдавить голову
меняться тв| меняется  изменением угла подъема плоскости крыльев
завести тв| Потом  завел
набирать вн| набирать высоту
уменьшаться дт| уменьшающемуся давлению
преодолеть тв| потом  ее  преодолела
показывать рд| моего альтиметра показывала
поить рд| цилиндров пели  уверенно  и  ровно,  как один
слышать рд| слышал этих криков о помощи
заплатить тв| заплатили жизнью
касаться рд| касаясь моего лица
направить вн| направил машину чуть ли  не
закрыть вн| закрывший землю
колыхать тв| колыхал  волнами
везти вн| вез  утреннюю почту
плыть рд| быстро плыли с запада
сиять тв| сияющими  фарами
полировать тв| полированной медью
научиться дт| Научиться  этому
осваивать вн| осваивать новую машину в темноте
выходить рд| ворота выходят на Лондонское шоссе
навалиться тв| всем телом  навалился  на  него
покрыться тв| покрылся холодным потом
держаться рд| держаться до конца
оставаться рд| Оставались  ворота  гаража
находиться рд| Ворота  находились
крутануть рд| изо  всех сил крутанул
тенить рд| тени  могучих дубов
двигаться рд| малейшего  желания двигаться
заметить вн| заметил  кучку  людей
проложен дт| проложена  авеню  Баграм
занимать вн| всю его заднюю часть  занимает
поместить вн| в  этой  комнате,  Дакр  поместил свою замечательную библиотеку  оккультной  литературы
потратить вн| потратил значительную часть своей  жизни
иметь вн| имели   сходную  направленность
искриться тв| искрились умом
сблизить рд| интересов сблизила
служить тв| служившей библиотекой и музеем
окидывать тв| окидывая взглядом  полки
гореть рд| горящего камина
окаймлён тв| окаймлена ободками
целовать вн| целую кварту
кромсать тв| кромсал его тупым ножом
заполнен тв| с геммами сплошь заполнена томами и  томами
выйти тв| Из  астролога  вышел  астроном
украшен тв| в  этом  старинном  доме украшена гербом  в  виде  щита  с  шевронами  и  красными
стереть тв| почти  стертые временем
напоминать вн| напоминала большую букву "Б"
пометить тв| пометил ее чужими инициалами
носить вн| носить такую корону
получать вн| не  раз  получал  важную  информацию
интересовать дт| кладу  интересующий
сохранять вн| сохраняет  определенную  атмосферу  или  ассоциацию
пожалеть рд| пожалел усилий
разделить вн| разделить  судьбу
составлять вн| молодого  американца, чьи аскетические привычки составляли
окружить тв| окружить  ее  всей роскошью
считать рд| считать  подобных своеобразных черточек характера
слышаться рд| слышалось звука шагов
обставлен пр| обставлена в одном вкусе
напугать тв| напуганный внезапной угрозой
поражать тв| все поражало глаз своей роскошью
счесть тв| сочли необъяснимой причудой
выказать тв| выказал  таким  способом
рассказывать вн| рассказываю эту историю
оказать дт| оказал  моему  индийскому дядюшке
назвать вн| наверняка назовете эту историю
рассказать пр| долгом ее рассказать
почитать тв| просто почитаю своим долгом ее
открыть вн| потом  открыл  частную практику в Бомбее
открыть тв| потом  открыл
изъездить дт| в качестве консультанта изъездил Индию  вдоль  и  поперек
изъездить вн| в качестве консультанта изъездил Индию  вдоль  и  поперек
проявлять рд| проявляя  чрезмерного радушия
нанести дт| нанести  ему
гаснуть пр1| гаснущем  свете  осеннего  дня
поражён тв| поражен  странной  таинственностью  пейзажа
увенчан тв| увенчаны мощнейшими бастионами
покоиться пр| сосуде покоится
облупить пр| облупленных   столбах
искалечить тв| искалеченными  геральдическими  щитами
сыпаться тв| дождем  сыпались
гореть тв| ровно горел желтым светом
свешиваться тв| низко  свешивающимся  карнизом
теплиться тв| от  невысокого  крыльца приветливо теплилось светом
прорезать рд| прорезающие щеки от глаз  до подбородка
мыть рд| При  моем
моем рд| При  моем
внести вн| Внесли лампу
выступать тв| выступающими костями
поставить дт| поставил ему
отравлен тв| отравлена страхом
уставлен тв| уставлен  пряными экзотическими деликатесами
гордиться рд| гордится  им
гордиться тв| гордится  им
гордиться дт| гордится  им
взволновать вн| взволновала хозяина и хозяйку
признаться рд| признался им
признаться тв| признался им
признаться дт| признался им
наблюдать вн| наблюдает  блуждающую  комету
поразить вн| Свитина,  Англию поразило
рассказать тв| рассказанная самим Шерлоком Холмсом           aka "Человек с белым лицом"
грешить тв| грешат   некоторой  ограниченностью
установить тв| установленный поклонниками таланта Артура Конан  Дойля
читать рд| мир  читает
выпустить вн| вдвоем  выпустили  книгу  "Подвиги Шерлока Холмса"
раскрыть тв| уже раскрытых  Шерлоком  Холмсом
следовать дт| следовать  стилю  Артура-Конан  Дойля
нокаутировать вн| К  удивлению  зрителей, Холмс нокаутировал Задиру
навязать дт| навязать  ему
вывихнуть вн| вывихнул ногу
передать вн| передал телеграмму
прочитать рд| прочитанных газет
запачкать тв| при  этом  запачкали ляписом
перебинтовать вн| перебинтовал  его  ногу
заканчиваться тв| заканчивалось размышлением в кресле
расследовать рд| нечего расследовать
заменить вн| заменив  подлинную картину Леонардо  да  Винчи
увлекаться тв| увлекается боксом
приходиться дт| ему приходится
бросить тв| брошенный  Холмсом
вынуть вн| вынул  золотую  табакерку  с  большим аметистом в середине крышки
подаренный дт| подаренную ему
знать рд| знали этого
нарушать вн| Тишину нарушало
работать тв| работает  ночным  сторожем  в  музее  восковых фигур мадам Топин
расстроить тв| Явно расстроенная упорством своего  дедушки
заслужить тв| заслуженной известностью
пожертвовать тв| пожертвует жизнью
закурить вн| закурить сигару
сохранить зв| Боже сохрани
снять вн| снял  взятку
снять дт| снял  взятку
мерцать тв| смутно  мерцали  тусклым светом сквозь  густые и
изливаться пр| этаже изливался
отмечать вн| отмечало холостяцкую квартиру  Френсиса  Перикорда
покоить пр| покоя энергии  и  трудолюбии
дополняться тв| дополнялся практической сметкой
уставить тв| уставленный большими  бутылями  для  кислоты
стоять рд1| Посреди всего этого  хлама  стояла  необычного  вида
вращаться рд1| необычного  вида  вращающаяся  с  ревом
подсоединён тв| подсоединена  множеством  проводов  к  широкому  стальному  фланцу,  или  поясу
метать тв| короткими  кулисами метали
висеть рд| озона  висел  в  воздухе
вытянуть вн| вытянул  вперед  тонкую  жилистую  руку
прикладывать рд| прикладывать  усилий
простираться дт| простираются к более возвышенным целям
мыть вн| мою  долю
увезти вн| увезти машину в деревню
сказать рд| сказал  механик
подкатить вн| минут  первого  его  кеб  подкатил к станции Виктория
снять тв| Снятые кебменом
вверен дт| вверены заботам кондуктора  багажного вагона
размахивать тв| размахивая  руками
выбелить тв| выбеленное  известкой
спускаться рд| спускавшейся с  гребня меловых гор
высадить вн| высадил небольшую  рощу
подходить дт| подходило  их  целям
возвестить рд| колес  возвестил
перерезать вн| перерезал  бечевку
зажечь вн| Зажгли лампу
предполагать вн| предполагаемую   мумию
прочить вн| прочили большую  карьеру
выбран тв| выбран хранителем музея на  Белмор-стрит
представлять дт| прежнему представляет
содержать вн| содержал музейную коллекцию
доверить дт| доверенную его заботам
расходовать вн| просто грешно  расходовать  пеньку
расходовать дт| просто грешно  расходовать  пеньку
умирать тв| умирать старомодным  способом
смотреть вн| в  клинику  смотреть  операцию
уклоняться рд| смысла  уклоняться
валить тв| валом валили вниз по улице
окончить вн| окончившие  школу
вырываться тв| вырывались сплошным шумным потоком из  ворот  университета
стучать тв| стуча  тростями  о  мостовую
перенумеровать тв| перенумерованными  дверями
застелить тв| застеленных  белыми  покрывалами
сидеть тв| сидевшая рядом
испещрить тв| испещренной странными маленькими белесыми волдырями
оценить вн| оценить их красоту
изогнуть тв| изогнутые  дугой
выложен тв| рядком  были  выложены
ведать тв| ведает инструментами
ввести рд| сестры  ввели  в  аудиторию
поддерживать вн| поддерживая женщину за талию
обнаружить тв| своим удивительным чутьем обнаружили
прорубить вн| прорубили горизонтальную штольню
зарасти тв| густо заросла кустарником
пересекать рд| пересекает  несколько  глубоких впадин
бежать рд| по которым бежит вода
запастись тв| запастись  свечами
найти вн| найти обратную дорогу к дневному свету
открыт дт| открыт всем ветрам
крыть тв| крытые шифером
омываться тв| омываются водами Ирландского моря
удовлетвориться тв| удовлетвориться  бесцветным  прозябанием  в  Западном   Райдинге
посвятить дт| посвятил  изучению
применять рд| высоких  знаний применяли в своих  трудах, желая скрыть драгоценные  истины от злых и  грубых  людей
начертать тв| начертанных  неизвестным народом на отвесных  скалах Южного Туркестана
поглотить тв| Поглощенный этими
очертить дт| гордо  и четко очерченному  лицу  моей  соседки
испачкать дт| испачканному платью
приложить рд| приложу  ума
интересоваться тв| интересуясь  моими  условиями
мыслить тв| ясностью и  четкостью мысли
переключить вн| переключил всю энергию на химию
обеспечить дт| о спектре металлов обеспечил ему
захвачен тв| захвачен египтологией
потребовать рд| потребовавшему срочных поездок в Лувр
предпринят тв| предпринята им
предпринят дт| предпринята им
заняться тв| заняться  делом
напоминать тв| напоминал своей формой
соответствовать дт| соответствовали его энергичному характеру и  проницательному  уму
возражать дт| возражал собеседнику
кивать тв| кивал ею
услышать тв| услышал  за  спиной
произнести вн| громко  произнесенную  фразу  на  английском языке
подчеркнуть пр| подчеркнутом пренебрежении к своему
кипеть тв| кипело   горечью   и   негодованием
уничтожить тв| едкими  замечаниями уничтожить
приключаться тв| приключаются  порой
образовать вн| образуя  Молвернскую  гряду
похоронить вн| похоронил жену
источать тв| источаемый штукатуркой обветшалого здания
вырезать тв| вырезали перочинным ножом
сутулиться рд| Спина  его  сутулилась  от  долгих ученых занятий
веять тв| холодом веяло в  его  присутствии
побаиваться рд| немного побаивались этого
нависнуть тв| нависшими  лохматыми бровями
попадаться дт| попадаться ему
управлять тв| управляющий имением
рисковать тв| рискуя собственной жизнью
нырнуть тв| нырнуть следом
заверить дт| заверив  его,  что теперь его мальчику
нахмурить тв| нахмуренным неподвижным лицом
увить тв| увитым плющом, и самой простой обстановкой
перетянуть тв| перетянутые тесемкой
окружён тв| окружена такой тайной
пересказать дт| пересказал вам
посвятить вн| посвятила всю  жизнь
выпить вн| сейчас выпить каплю  спиртного
отведать дт| тигру отведать
удерживать рд| удерживает его до сих пор
тереть дт| три  года  тому
вести вн| вести нескончаемую борьбу
идти тв| идущую коридором
принять вн| приняла  телесную форму
вцепиться дт| при  малейшей  его  неосторожности вцепиться ему
представляться дт| представлялась моему мысленному взору
составить дт| составить ему
обнаружен тв| обнаружен  утром  своим
просунуть вн| просунутыми в одну штанину
корениться рд| сложной  натуры  коренилась
охватить тв| потом его  внезапно охватила
любить вн| любила новизну
слыть тв| слыл страстным садоводом
предложить вн| предложил руку,  титул и треть
опостылеть тв| сценой  опостылело
блеснуть тв| вновь  блеснуть талантом
положить тв| положило им
положить рд| положило им
положить дт| положило им
зажечь рд| зажженного  камина  в своем  кабинете
любоваться тв| глазами  знатока   любовался
деть вн| день  операцию
подать вн| подать карету
сгорбить тв| сгорбленного годами и недугами
располагать тв| располагаем  подробным  и  ясным  рассказом
прославить пр| столь прославленном средоточии
связан тв| связаны  между  собой
плющить тв| ветвями  плюща
выщерблен тв| выщерблены  ногами  бесчисленных поколений искателей знаний
стереться рд| старого  кладбища  стершаяся
цениться тв| в  башне  очень  ценились  наиболее   усердными
покуривать вн| покуривая  трубку
уделять дт| уделяя спорту
знаменовать вн| знаменует  вершину
попыхивать тв| попыхивая  трубкой,  Аберкромб  Смит
наблюдать рд| наблюдал  ничего
выколотить вн| выколотил трубку об решетку
знать тв| знал ее еще ребенком
случиться тв| случилось прошлой зимой
знать дт| знаешь  тропу вдоль речки
идти рд| Тропа  шла  между  речкой и громадной лужей
почесть вн| почти с реку
почтить вн| почти с реку
столкнуть вн| столкнул старушку в грязь
высказать дт| откровенно высказал ему
швырнуть вн| швырнул трубку в корзину для бумаг
украсить тв| украшенный  огромными цветными  схемами  таинственного  царства  наших  внутренностей
обещать дт| обещал ему
блестеть тв| блестящими способностями
отложить вн| отложил  книгу
гасить вн| уже гасил лампу
обратиться тв| обратившись мыслями к  соседу,  Смит
принимать тв| утром и вечером принимает
подышать тв| подышать свежим  воздухом
обретать вн| обретает  первозданную  привлекательность
наступать рд| наступающего  дня
пропитать тв| пропитанный дымом
обрамить тв| обрамленный  желтым  полумесяцем прибрежного песка
плыть тв| медленно  плывущими  облаками
залит тв| залито золотым светом
освещать пр1| освещая  на  дне
наполнен тв| наполнен  криками
очертить тв| красиво  очерченными губами
сделаться тв| сделались  непосильной  ношей
посоветовать дт| посоветовал вам
загнуть тв| загнутыми  краями
выбрить тв| с большим мясистым чисто  выбритым  лицом
фантазировать тв| фантазировал   таким  нелепым  образом
подсматривать рд| малейшего намерения подсматривать
написан тв| написано женской рукой
опустить тв| опущенными  уголками
портить вн| портила  правильную  линию
написать тв| опять  написанное  женским  почерком
трястись тв| Трясущимися  пальцами
заменить дт| заменившая  ему
сочинить вн| сочинил целую  историю  небритого  старика
отбрасывать тв| отбрасывал   тростью
заговорить тв| заговорил тихим голосом
приехать тв| приехала  самым ранним
наскучить дт| наскучил вам
посчастливиться дт| ему  посчастливилось
радоваться дт| радоваться  своему  счастью
протянуть дт| протянул  ему
сдержать вн| руку,  но  другое,  более  высокое  соображение  вежливости сдержало
подниматься тв| Уверенной  походкой  поднималась
согнуться рд| спина согнется
войти пр| том  "Сочинений" вошли
заключаться тв| этими  крайностями  заключалось
заставлять дт| собственным  убеждениям заставляла
истерзан тв| истерзан борьбою
рассечь вн| рассекший  надвое  каждую  деревню,  каждый  дом
литься тв| лились  рекою  с
осквернять вн| осквернял  религиозную  историю  мира
заражён тв| заражены учением Афанасия или Ария
утверждать пр| Ариане утверждали
возмущён тв| возмущен крайностями  в  гонениях  на  ариан
открыть дт| ему открыл
сбить пр| крепко  сбитом  человеке
пригласить тв| жестом пригласил
обставить вн| скромно  обставленную  приемную
обязан тв| обязан таким цветом  лица
понять дт| понять пациенту
постукивать тв| легонько  постукивая им
постукивать дт| легонько  постукивая им
прикрыть тв| прикрыв рот большой красной ладонью
прикрыть рд| прикрыв рот
доставлять дт| доставляете  врачам
делать дт| нам делать
причинять дт| причиняли доктору
припрятан рд| стола припрятаны
наметать тв| наметанным  глазом
разложить тв| образом  разложил  их
поставить рд| поставил несколько чернильных  клякс
заполнить вн| заполнил первую  страницу  в  каждой  книге
воображать пр| воображаемых визитах
нанести тв| нанес  безымянным  больным
уронить вн| уронил  голову на руки
начинать вн| едва  начинающего  карьеру
начинать дт| едва  начинающего  карьеру
иметь рд1| имеешь собственного дома
замечать дт| делам и едва ли замечал  маленькую  медную  табличку  на  ней
замечать вн| замечал  маленькую  медную  табличку
страдать тв| страдающие  дурным  пищеварением
шепнуть дт| шепнуть ему
окинуть тв| окинул взглядом
отпустить вн| чуть отпустив цепочку замка
прогнать рд| прогнать их с порога
повязан тв| повязана желтым шелковым платком
показать вн| показала  крохотную  темноволосую  черноглазую  девочку
слипаться тв| слипающимися со сна глазенками
сидеть рд| древнего  Рима  сидели  в  уютной  комнате Кеннеди, окна
тронуть тв| тронутые  дыханием
увешан тв| увешан старинными вещами
хотя дт| хотя  ему
давать дт| дает  ему
поддаваться дт| часто  поддавался соблазнам
отражать вн| все отражало силу
отражать дт| все отражало силу
понимать тв| любой  понимал
присудить дт| присудил  ему
прерывать рд| прерывал своих занятий
развиться дт| развиться другим  качествам  своей натуры
дышать тв| дышало жизнью
ощущать вн| слишком болезненно ощущал свою  ограниченность  в других областях
оценить тв| способными  оценить
очарован тв| очарован  блеском  и  живостью  ума
пожимать тв| пожимал плечами
преобладать пр| кружке  преобладало
глядеть дт| твердо глядя в  глаза  своему  приятелю
показать тв| показал рукой на  коврик
зажигать вн| пока Бергер медленно зажигал сигару
произвести вн| произведут  сенсацию
изучать вн| всю жизнь изучать
произойти тв| Джеймсом Винтером произошла при весьма  драматических  обстоятельствах
заглушать тв| с помощью женщин заглушал фланелевой  юбкой
сбить рд| сбил  с  носа
описывать вн| описывает мою  внешность
маячить рд| моего  безмятежного  существования  маячило
сработать тв| сработанные   деревенским   сапожником
склоняться рд| спина  его  столько  раз  склонялась  над  ложем
осуждать вн| гневно осуждал Роберта Пиля и  отмену
отдавать вн| юношу  отдавали в обучение к хирургу
штудировать вн| анатомию  штудировали
щёлкать тв| недоверчиво  щелкает  языком
выступать пр| на глазах  выступали
выступать рд| выступали слезы
лечить тв| очень модно  лечить  диетой
превосходить тв| превосходит  своими  познаниями
доверять дт| доверять собственным пальцам
избрать тв| избрали  его  президентом  местного отделения Ассоциации английских  медиков
выпускать вн| выпускают  руку  доктора
лечить вн| лечить  всю  округу
застроить тв| застроенных кирпичными  зданиями
доноситься рд| арсенала  доносился
падать рд1| грохота  падающих
закоптить тв| За  арсеналом  закопченные  дымом
расходиться тв| расходились лучами
давать вн| дававшее  работу
измучить тв| измученными дневным трудом
сказать вн| сказал  правду, миссис
постучать тв| постучал палкой
торжествовать тв| торжествующим видом
задать дт| задать  ему
спрашивать тв| спрашивающую  критическим взглядом
отвести дт| отведенный ему
звучать рд| этого высказывания звучала как
подлежать дт| подлежит  никакому сомнению
наставить пр| способном  наставить
разбавить тв| слегка разбавленный  немногочисленными достойными гражданами
хозяйничать тв| хозяйничал с небольшой  шайкой головорезов,  таких  же отпетых
добыть тв| Добытые обитателями
поручен рд| примитивного банка были поручены
поручен дт| поручены  доверенному  человеку  по  фамилии  Уобэрн
выполнять вн| старателей, которые по очереди выполняли
разоблачить вн| которую Холмс  разоблачил в молодежном пансионате
оказать вн| оказал  большую услугу Британской ассоциации гробовщиков в деле, подробности
наступить тв| наступил второй
ждать рд| давно ждал этого
пропахнуть тв| пропахла  химикатами
удушать тв| удушающим   чадом   его   любимого  пакистанского табака
разъярить дт| разъяренному  быку
приплюснуть тв| приплюснутым  носом
настораживать тв| настораживающей походкой
поднимать вн| поднимал кочергу
терпеть рд| терплю подобной болтовни
понадобиться дт| кому  понадобилось
командовать тв| Стивом Дикси командует непосредственно
решить дт| решили вам
являть тв| являли собой
оправдать вн| неубедительную попытку оправдать
отметить тв| отмеченной печатью истинно высокой
возрасти тв| возросшим интересом
довестись тв| Немногим  довелось
довестись дт| Немногим  довелось
помочь тв| Уотсоном рады помочь
назваться тв| назвавшийся агентом по торговле
назначить вн| назначила цену
зависеть рд| зависеть до конца моих дней
подготовить тв| подготовленным  договором
указать дт| указала  ему
забирать рд| забирать  ничего
попросить тв| Холмс жестом  попросил
пересечь вн| затем осторожно пересек комнату
поймать дт| пойманную им
поймать тв| пойманную им
вырывать тв| силой вырывают из родного курятника
прерывать вн| прерывать любопытную историю
удивить дт| удивленное  лицо  к  Холмсу
взбесить тв| взбешенной  женщиной
зарыть пр| зарытом кладе
требоваться тв| им  требуется
требоваться рд| им  требуется
требоваться дт| им  требуется
домогаться рд| так  домогаются  вашего  чайного  сервиза
выяснить тв| выяснить методом логического анализа
подождать рд| подождать дальнейшего развития событий
хлопнуть тв| хлопнувшей парадной дверью
провести вн| в  необходимости  провести  ночь-другую
потребоваться дт| вам потребуется
оставить тв| недвижимостью оставил
скрывать рд| скрывают адресов своих контор
взяться дт| Откуда взяться дорогим вещам при таком  небольшом  годовом доходе
опустить вн| опустить руку в карман
продолжать вн| продолжать беседу об истории господина Перкинса
принадлежать рд| Спенсера Джона, а Дикси принадлежит
поставлять вн| поставляемые  каждую  неделю
помогать дт| помогал знаменитому сыщику
подежурить тв| подежурить ночью на вилле
представиться тв| представившийся  адвокатом  Сатро
пренебречь тв| пренебрегла его опытом
исписан тв| исписана  рукой Дугласа
поступать дт| вам поступать так
научить дт| научил  этому
осматривать вн| осматривать бумагу
украсть вн| с намерением украсть подобную рукопись
найти рд| найдя ничего
начинаться тв| начиналась следующим образом:       "... по лицу текла кровь из ран от порезов и ударов. Но это не шло ни  в какое сравнение с  тем,  как  обливалось  кровью  его  сердце  при  виде  прекрасного лица, ради которого он готов  был  пожертвовать  даже  жизнью.  Женщина засмеялась. Да, можно было поклясться чем угодно, что  она  именно  смеялась, как безжалостный демон, в тот момент, когда он взглянул на  нее.  Мгновенно любовь умерла, и родилась ненависть. Ведь  мужчина  должен  жить  ради чего-то. Если не ради вашей взаимности, мадам, то уж  наверняка  ради  моей мести, несущей вам погибель"
обследовать вн| Обследуйте  палку
лежать тв| лежал плотным слоем
искажаться тв| искажалось гримасами
огласить тв| огласив звоном
провести тв| провел платком по лбу
расширять вн| расширять  клиентуру
ссужать тв| ссужаем крупными суммами
вернуть вн| вернут крупную сумму денег
погасить вн| погашу  вашу ссуду с уплатой
принять рд| принял меры деловой предосторожности
оставить вн| оставить диадему
поднять тв| колебанием  поднял глаза на своего именитого посетителя
моем пр1| моем  письменном столе
мыть пр1| моем  письменном столе
запереть вн| запер  диадему  в  свой личный сейф
держать вн| держать диадему
мочь дт| мог ему
придерживаться рд| того  же  взгляда  придерживалась
умереть дт| тому назад умер
отказывать дт| отказывала ему
подавать дт| подававшая нам
заинтриговать тв| заинтригованные  моим  рассказом
посмотреть вн| посмотреть знаменитую диадему
подойти тв| К нему подойдет любой
придать дт| придал значения его  словам
вынести рд| вынесу  такого позора
раздобыть тв| раздобыть их иным способом
брать вн| Обычно  эту обязанность берет на себя
способствовать дт| способствовало крепкому сну
выронить вн| выронил диадему
хватать рд| хватало  золотого  зубца
сломать вн| Сломать такую  вещь
вызвать вн| вызвать полицию
предъявить дт| предъявить  ему
дать тв| дашь  им
потрясти вн| потрясет всю нацию
вызвать рд| бериллов вызовет огромный скандал
усугубить вн| усугубит твою вину
отправить тв| утром его отправили в тюрьму
смочь пр| смогут  чем-
потерять вн| потерял честь, состояние и сына в одну
видеть вн| собственными  глазами  видел  диадему в руках
отломать рд| отломанного зубца
уравновесить дт| удивительно  уравновешенному  уму
сорвать тв| превосходным  средством  сорвать
ненавидеть тв| ненавидевший  своей  цыганской  душой
увлечён тв| увлечен расследованием преступлений
признан тв| официальной  полицией  были  признаны
выполнить дт| выполненном им
выполнить рд| выполненном им
выполнить тв| выполненном им
временить рд| времени  моего  сватовства
промелькнуть тв| силуэтом промелькнула
заложить вн| заложив за спину
навеять тв| навеянные наркотиками
почтить рд| почти параллельных царапин
почесть рд| почти параллельных царапин
закуривать вн| закуривая папиросу
обосновывать вн| к  своей  теории,  вместо  того  чтобы  обосновывать  теорию
подражать дт| подражать приемам моего друга
получать рд| со всех сторон получали"?  Француз  или русский  не  мог  бы  так  написать.  Только  немцы  так  бесцеремонно  обращаются со своими глаголами. Следовательно, остается только узнать, что  нужно этому немцу, который пишет на богемской бумаге и предпочитает носить  маску, лишь бы не показывать своего лица...  Вот  и  он  сам,  если  я  не  ошибаюсь. Он разрешит все наши сомнения.       Мы услышали резкий стук лошадиных копыт и  визг  колес,  скользнувших  вдоль ближайшей обочины. Вскоре затем кто-то с силой дернул звонок.       Холмс присвистнул.       - Судя по звуку, парный экипаж... Да,  -  продолжал  он,  выглянув  в  окно, - изящная маленькая карета и пара рысаков... по сто пятьдесят  гиней  каждый. Так или иначе, но это дело пахнет деньгами, Уотсон.       - Я думаю, что мне лучше уйти, Холмс?       - Нет, нет, оставайтесь! Что я стану делать без моего биографа?  Дело  обещает быть интересным. Будет жаль, если вы пропустите его.       - Но ваш клиент...       - Ничего, ничего. Мне может понадобиться ваша помощь, и  ему  тоже...  Ну,  вот  он  идет.  Садитесь  в  это  кресло,  доктор,  и  будьте   очень  внимательны.       Медленные, тяжелые шаги, которые мы слышали на лестнице и в коридоре,  затихли перед самой нашей дверью. Затем раздался громкий и властный стук.       - Войдите! - сказал Холмс.       Вошел человек ростом едва ли меньше шести футов  и  шести  дюймов[3],  геркулесовского сложения. Он был одет роскошно, но эту роскошь сочли бы  в  Англии вульгарной. Рукава и отвороты его двубортного пальто были оторочены  тяжелыми полосами каракуля; темно-синий  плащ,  накинутый  на  плечи,  был  подбит огненно-красным шелком и застегнут на шее  пряжкой  из  сверкающего  берилла. Сапоги, доходящие  до  половины  икр  и  обшитые  сверху  дорогим  коричневым мехом, дополняли то впечатление  варварской  пышности,  которое  производил весь его облик. В руке он держал широкополую шляпу,  а  верхняя  часть его лица была закрыта черной маской,  опускавшейся  ниже  скул.  Эту  маску, походившую на забрало, он, очевидно, только что надел, потому  что,  когда он вошел, рука его была еще поднята. Судя по нижней части лица,  это  был человек  сильной  воли:  толстая  выпяченная  губа  и  длинный  прямой  подбородок говорили о решительности, переходящей в упрямство.       - Вы получили мою записку? - спросил  он  низким,  грубым  голосом  с  сильным немецким акцентом. - Я сообщал, что приду к вам. - Он  смотрел  то  на одного из нас, то на другого, видимо не зная, к кому обратиться.       - Садитесь, пожалуйста. - сказал Холмс. - Это  мой  друг  и  товарищ,  доктор Уотсон. Он так добр, что иногда помогает мне в моей работе.  С  кем  имею честь говорить?       - Вы можете считать,  что  я  граф  фон  Крамм,  богемский  дворянин.  Полагаю, что этот джентльмен,  ваш  друг,  -  человек,  достойный  полного  доверия, и я могу посвятить его в дело чрезвычайной важности? Если это  не  так, я предпочел бы беседовать с вами наедине.       Я встал, чтобы уйти, но Холмс схватил меня за руку и толкнул  обратно  в кресло:       - Говорите либо с нами обоими, либо не говорите. В присутствии  этого  джентльмена вы можете сказать все, что сказали бы мне с глазу на глаз.       Граф пожал широкими плечами.       - В таком случае я должен прежде всего взять с вас обоих  слово,  что  дело, о котором я вам сейчас расскажу, останется  в  тайне  два  года.  По  прошествии двух лет это не будет иметь значения. В настоящее время я могу,  не преувеличивая, сказать: вся эта история настолько серьезна,  что  может  отразиться на судьбах Европы.       - Даю слово, - сказал Холмс.       - И я.       -  Простите  мне  эту  маску,  -  продолжал  странный  посетитель.  -  Августейшее лицо, по поручению которого я действую,  пожелало,  чтобы  его  доверенный остался для вас неизвестен, и я должен признаться,  что  титул,  которым я себя назвал, не совсем точен.       - Это я заметил, - сухо сказал Холмс.       - Обстоятельства очень щекотливые, и  необходимо  принять  все  меры,  чтобы из-за них не  разросся  огромный  скандал,  который  мог  бы  сильно  скомпрометировать одну из царствующих династий Европы. Говоря проще,  дело  связано с царствующим домом Ормштейнов, королей Богемии.       - Так я и думал, - пробормотал Холмс, поудобнее располагаясь в кресле  и закрывая глаза.       Посетитель с явным удивлением  посмотрел  на  лениво  развалившегося,  равнодушного  человека,  которого  ему,  несомненно,  описали  как  самого  проницательного и самого энергичного из всех  европейских  сыщиков.  Холмс  медленно открыл глаза и  нетерпеливо  посмотрел  на  своего  тяжеловесного  клиента.       - Если ваше величество соблаговолите посвятить нас  в  свое  дело,  -  заметил он, - мне легче будет дать вам совет.       Посетитель вскочил со стула и принялся шагать по  комнате  в  сильном  возбуждении. Затем с жестом отчаяния он сорвал с лица маску и  швырнул  ее  на пол.       - Вы правы, - воскликнул он, - я король! Зачем мне пытаться  скрывать  это?       - Действительно, зачем? Ваше величество еще не начали говорить, как я  уже знал, что передо мной  Вильгельм  Готтсрейх  Сигизмунд  фон  Ормштейн,  великий князь Кассель-Фельштейнский и наследственный король Богемии.       - Но вы понимаете, - сказал наш странный посетитель, снова усевшись и  поводя рукой по высокому белому лбу, - вы понимаете, что я не привык лично  заниматься такими делами! Однако вопрос настолько щекотлив, что я  не  мог  доверить его кому-нибудь из полицейских агентов, не рискуя оказаться в его  власти. Я приехал из Праги инкогнито специально затем, чтобы обратиться  к  вам за советом.       - Пожалуйста, обращайтесь, - сказал Холмс, снова закрывая глаза.       - Факты вкратце таковы: лет пять  назад,  во  время  продолжительного  пребывания в Варшаве, я познакомился с хорошо известной авантюристкой Ирэн  Адлер. Это имя вам, несомненно, знакомо?       - Будьте любезны, доктор, посмотрите в моей картотеке, -  пробормотал  Холмс, не открывая глаз.       Много  лет  назад  он  завел  систему  регистрации   разных   фактов,  касавшихся людей и вещей, так что трудно было назвать лицо или предмет,  о  которых он не мог  бы  сразу  дать  сведения.  В  данном  случае  я  нашел  биографию Ирэн Адлер между  биографией  еврейского  раввина  и  биографией  одного начальника штаба, написавшего труд о глубоководных рыбах.       - Покажите-ка, - сказал Холмс. - Гм! Родилась  в  Нью-Джерси  в  1858  году. Контральто, гм...  Ла  Скала,  так-так!..  Примадонна  императорской  оперы в Варшаве, да! Покинула оперную сцену, ха!  Проживает  в  Лондоне...  совершенно верно! Ваше величество, насколько я понимаю, попали  в  сети  к  этой молодой особе, писали ей компрометирующие письма и теперь  желали  бы  вернуть эти письма.       - Совершенно верно. Но каким образом?       - Вы тайно женились на ней?       - Нет.       - Никаких документов или свидетельств?       - Никаких.       - В таком случае, я вас не понимаю, ваше величество. Если эта молодая  женщина захочет использовать письма для шантажа или других целей, как  она  докажет их подлинность?       - Мой почерк.       - Пустяки! Подлог.       - Моя личная почтовая бумага.       - Украдена.       - Моя личная печать.       - Подделка.       - Моя фотография.       - Куплена.       - Но мы сфотографированы вместе!       - О-о, вот это очень плохо! Ваше величество  действительно  допустили  большую оплошность.       - Я был без ума от Ирэн.       - Вы серьезно себя скомпрометировали.       - Тогда я был всего лишь кронпринцем.  Я  был  молод.  Мне  и  теперь  только тридцать.       - Фотографию необходимо во что бы то ни стало вернуть.       - Мы пытались, но нам не удалось.       - Ваше величество должны пойти на издержки: фотографию надо купить.       - Ирэн не желает ее продавать.       - Тогда ее надо выкрасть.       - Было сделано пять попыток.  Я  дважды  нанимал  взломщиков,  и  они  перерыли весь ее дом. Раз, когда она путешествовала, мы обыскали ее багаж.  Дважды ее заманивали в ловушку. Мы не добились никаких результатов.       - Никаких?       - Абсолютно никаких.       Холмс засмеялся.       - Ничего себе задачка! - сказал он.       - Но для меня это  очень  серьезная  задача!  -  с  упреком  возразил  король.       - Да, действительно. А что она намеревается сделать с фотографией?       - Погубить меня.       - Но каким образом?       - Я собираюсь жениться.       - Об этом я слышал.       - На Клотильде Лотман фон  Саксен-Менинген.  Быть  может,  вы  знаете  строгие  принципы  этой  семьи.  Сама  Клотильда  -  воплощенная  чистота.  Малейшая тень сомнения относительно моего прошлого привела бы к разрыву.       - А Ирэн Адлер?       - Она грозит, что пошлет фотоснимок родителям моей невесты. И пошлет,  непременно пошлет! Вы ее не знаете. У нее железный характер. Да, да,  лицо  обаятельной женщины, а  душа  жестокого  мужчины.  Она  ни  перед  чем  не  остановится, лишь бы не дать мне жениться на другой.       - Вы уверены, что она еще не отправила фотографию вашей невесте?       - Уверен.       - Почему?       -  Она  сказала,  что  пошлет  фотографию  в  день  моей  официальной  помолвки. А это будет в ближайший понедельник.       - О, у нас остается три дня! - сказал Холмс, зевая.  -  И  это  очень  приятно, потому что сейчас мне надо заняться  кое-какими  важными  делами.  Ваше величество, конечно, останетесь пока что в Лондоне?       - Конечно. Вы можете найти меня в гостинице Лэнгхэм под именем  графа  фон Крамма.       - В таком случае, я пришлю вам записочку - сообщу,  как  продвигается  дело.       - Очень прошу вас. Я так волнуюсь!       - Ну, а как насчет денег?       - Тратьте, сколько найдете нужным. Вам предоставляется полная свобода  действий.       - Абсолютно?       - О, я готов отдать  за  эту  фотографию  любую  из  провинций  моего  королевства!       - А на текущие расходы?       Король достал из-за плаща тяжелый кожаный мешочек и  положил  его  на  стол.       - Здесь триста фунтов золотом и семьсот ассигнациями, - сказал он.       Холмс написал расписку на страничке своей записной  книжки  и  вручил  королю.       - Адрес мадемуазель? - спросил он.       - Брайони-лодж, Серпантайн-авеню, Сент-Джонсвуд.       Холмс записал.       - И еще один вопрос, -  сказал  он.  -  Фотография  была  кабинетного  размера?       - Да, кабинетного.       - А теперь доброй ночи, ваше величество, и я надеюсь, что скоро у нас  будут хорошие вести... Доброй ночи, Уотсон, -  добавил  он,  когда  колеса  королевского экипажа застучали по мостовой. - Будьте любезны зайти  завтра  в три часа, я бы хотел потолковать с вами об этом деле.      II         Ровно в три часа я был на Бейкер-стрит, но  Холмс  еще  не  вернулся.  Экономка сообщила мне, что он вышел из дому в начале девятого. Я уселся  у  камина с намерением дождаться его, сколько бы мне  ни  пришлось  ждать.  Я  глубоко  заинтересовался  его  расследованием,  хотя   оно   было   лишено  причудливых и мрачных черт, присущих тем двум преступлениям, о  которых  я  рассказал в другом месте.  Но  своеобразные  особенности  этого  случая  и  высокое положение клиента придавали делу  необычный  характер.  Если  даже  оставить в стороне самое содержание исследования, которое  производил  мой  друг, - как удачно, с каким мастерством он сразу овладел всей ситуацией  и  какая строгая,  неопровержимая  логика  была  в  его  умозаключениях!  Мне  доставляло истинное удовольствие следить за быстрыми, ловкими приемами,  с  помощью которых он разгадывал самые запутанные тайны. Я настолько привык к  его неизменным триумфам, что самая возможность неудачи не  укладывалась  у  меня в голове.       Было около четырех часов, когда дверь отворилась и  в  комнату  вошел  подвыпивший  грум[4],  с  бакенбардами,  с   растрепанной   шевелюрой,   с  воспаленным  лицом,  одетый  бедно  и  вульгарно.  Как  ни  привык   я   к  удивительной способности моего  друга  менять  свой  облик,  мне  пришлось  трижды вглядеться, прежде  чем  я  удостоверился,  что  это  действительно  Холмс. Кивнув мне на ходу, он исчез в своей спальне, откуда появился через  пять минут в темном костюме, корректный, как всегда. Сунув руки в карманы,  он протянул ноги к пылающему камину и несколько минут весело смеялся.       - Чудесно! - воскликнул он, затем закашлялся и снова расхохотался, да  так, что под конец обессилел и в полном изнеможении  откинулся  на  спинку  кресла.       - В чем дело?       - Смешно, невероятно смешно! Уверен, что вы никогда не угадаете,  как  я провел это утро и что я в конце концов сделал.       - Не могу себе представить. Полагаю, что вы наблюдали  за  привычками  или, может быть, за домом мисс Ирэн Адлер.       - Совершенно  верно,  но  последствия  были  довольно  необычайные...  Однако расскажу по порядку. В начале девятого я вышел из  дому  под  видом  безработного  грума.  Существует  удивительная   симпатия,   своего   рода  содружество между всеми, кто имеет дело с лошадьми. Станьте грумом,  и  вы  узнаете все, что вам надо. Я  быстро  нашел  Брайони-лодж.  Это  крохотная  шикарная  двухэтажная  вилла;  она  выходит  на  улицу,  позади  нее  сад.  Массивный замок на садовой калитке. С  правой  стороны  большая  гостиная,  хорошо обставленная, с высокими  окнами,  почти  до  полу,  и  с  нелепыми  английскими оконными затворами, которые мог бы открыть и ребенок. За домом  ничего особенного, кроме того, что к окну галереи можно добраться с  крыши  каретного сарая. Я обошел этот сарай со всех сторон и рассмотрел его очень  внимательно, но ничего интересного не заметил. Затем я пошел вдоль улицы и  увидел, как я и ожидал, в переулке, примыкающем к стене сада,  конюшню.  Я  помог конюхам чистить лошадей и получил за это два  пенса,  стакан  водки,  два пакета табаку и вдоволь сведений о мисс Адлер,  а  также  и  о  других  местных жителях. Местные жители меня не интересовали нисколько, но  я  был  вынужден выслушать их биографии.       - А что вы узнали об Ирэн Адлер? - спросил я.       - О, она вскружила головы всем мужчинам  в  этой  части  города.  Она  самое прелестное существо из всех, носящих дамскую шляпку на этой планете.  Так говорят в один  голос  все  серпантайнские  конюхи.  Она  живет  тихо,  выступает иногда  на  концертах,  ежедневно  в  пять  часов  дня  выезжает  кататься и ровно в семь возвращается к  обеду.  Редко  выезжает  в  другое  время, кроме тех случаев, когда она поет. Только один мужчина посещает  ее  - только один, но зато очень часто. Брюнет, красавец, прекрасно одевается,  бывает у нее ежедневно, а порой и по два раза в  день.  Его  зовут  мистер  Годфри Нортон из Темпла[5]. Видите, как выгодно войти в доверие к кучерам!  Они его возили домой от серпантайнских конюшен раз двадцать и  все  о  нем  знают. Выслушав то, что они мне рассказывали, я снова  стал  прогуливаться  взад и вперед вблизи Брайони-лодж и обдумывать дальнейшие действия.       Этот Годфри Нортон, очевидно, играет существенную роль во всем  деле.  Он юрист. Это звучит зловеще. Что их связывает и какова причина его частых  посещений? Кто она: его клиентка? Его друг? Его возлюбленная? Если она его  клиентка, то, вероятно, отдала ему на  хранение  ту  фотографию.  Если  же  возлюбленная - едва ли. От решения этого вопроса  зависит,  продолжать  ли  мне  работу  в  Брайони-лодж  или  обратить  внимание  на  квартиру   того  джентльмена в Темпле. Этот вопрос очень щекотлив  и  расширяет  поле  моих  розысков... Боюсь, Уотсон, что надоедаю вам этими подробностями, но, чтобы  вы поняли всю ситуацию, я должен открыть вам мои мелкие затруднения.       - Я внимательно слежу за вашим рассказом, - ответил я.       - Я все еще взвешивал в уме это дело, когда к  Брайони-лодж  подкатил  изящный  экипаж  и  из  него  выскочил  какой-то  джентльмен,   необычайно  красивый, усатый, смуглый, с  орлиным  носом.  Очевидно,  это  и  был  тот  субъект, о котором я слышал. По-видимому, он очень  спешил  и  был  крайне  взволнован. Приказав кучеру ждать, он пробежал мимо  горничной,  открывшей  ему дверь, с видом человека, который чувствует себя в этом доме хозяином.       Он пробыл там около получаса, и мне было видно через  окно  гостиной,  как он ходит взад и вперед по комнате,  возбужденно  толкует  о  чем-то  и  размахивает руками. Ее я не видел. Но вот он вышел  на  улицу,  еще  более  взволнованный. Подойдя к экипажу, он  вынул  из  кармана  золотые  часы  и  озабоченно посмотрел на них. "
торчать рд| узел галстука торчал под самым ухом
повредить дт| повредить другому человеку".       Холмс приподнялся на диване, и я увидел, что он делает движения,  как  человек, которому не хватает воздуха. Служанка бросилась к окну  и  широко  распахнула его. В то же мгновение Холмс поднял руку; по  этому  сигналу  я  бросил в комнату ракету и крикнул: "
пожелать дт| довольно неосторожно пожелала вам
оставлять вн| оставляю  здесь  другую  фотографию
предать дт| преданная  вам
запрячь тв| запряженная парой лошадей
подъесть тв| подъем  путешественником
помещать рд| помещала особенно подробных отчетов
объяснить дт| объясню  вам
сделаться пр| богаче,  и  Маккарти сделался
разлиться тв| разлившимся ручьем
тереть рд1| три часа
напуган тв| напугана  этой  ужасной  сценой
затеять вн| затеяли ссору
размозжён тв| размозжен ударами
представить рд| представить более гнусного дела
дать пр| данном случае
указывать пр| указывать в одном направлении
пригодиться дт| пригодится  нам
сложиться пр| сложившихся  обстоятельствах
изобличать вн| изобличает его незаурядное самообладание и выдержку
заслуживать рд| заслуживает  ареста
нагрубить дт| что  нагрубил  отцу
перегнуть вн| перегнув страницу
произойти дт| всему происшедшему
вернуться тв| вернулся  как раз утром в прошлый понедельник
хотеть тв| хотите этим
рассмотреть вн| рассмотреть эту вещь
находиться пр| находилась на расстоянии
вредить дт| сильно вредит сыну
приписывать дт| что приписываете ему
придумать рд| придумать  такой  причины  ссоры
исчезнуть тв| исчезнувшей одеждой
миновать вн| миновав  прелестную  Страудскую  долину
посвящён тв| им посвящены
посвящён дт| им посвящены
посвящён рд| им посвящены
оседать тв| маслянистыми каплями  оседающая  на стеклах
подавлять вн| подавляя свою энергию
мочь тв| может  невидимкой
разыгрываться дт| разыгрываться более  глубоким  драмам
свернуть рд| трамвай вдруг свернул  с  рельсов
давать рд| дает объяснений
покинуть пр| планете покинуть
наделить тв| наделенный  величайшей, неслыханной способностью
вручать дт| Ему  вручают
разложен дт| все  разложено  по  полочкам
поглощён дт| его мысли тем  только и поглощены
спуститься рд| спуститься с Олимпа
изменить дт| изменить своим привычкам
взять рд| черт  возьми
подозревать рд| особых  оснований подозревать
обнаружить рд| обнаружило много новых фактов
смотреть рд| смотреть  с  запада на восток
ехать тв| ехал ночным поездом
предъявить рд| предъявив  билета
пояснить дт| нам пояснит
возвышаться тв| массивным  телом  возвышалась
посадить тв| глубоко посаженными глазами цвета стали
пожать дт| пожал нам
опрокинуть пр| опрокинутом улье
поднять рд| пресса подняла
ждать пр| другом  ждали
ехать дт| самому  ехать в  Вулидж
разрешить вн| разрешить  проблему
недоставать рд| недостающих чертежа
храниться тв| хранится второй
числиться тв| числился младшим  клерком
продать вн| продать  военную   тайну
довольствоваться тв| довольствоваться  этими  гипотезами
оказать рд| случая оказать
не ждали рд| многого не жди
почудиться дт| ему почудилось
прикован рд1| Глаза моего друга были прикованы к тому месту
развинтить вн| развинченную  фигуру  в  халате  мышиного  цвета
оставить дт| оставленный ему
спустить вн| слабо освещенную гостиную, и минуту спустя  туда
пережить рд| пережить  такого  позора
содействовать дт| содействовать раскрытию дела
совестить тв| терзаниями совести за невыполненный перед родиной долг
представиться дт| представилась нам
поделиться тв| поделиться ею
приходить дт| ему  приходила
умереть рд| департамента умер
попалить рд| чертежа  попали
попасть рд| чертежа  попали
построить вн| построить  подводную  лодку  Брюса-Партингтона
отсутствовать рд| отсутствующие чертежа
утратить вн| утратили свою  ценность
собрать вн| собрать  сдачу
выбирать рд| Выбирая несколько типичных дел
переносить вн| переносить жару
закрыться рд| парламента закрылась
перебирать тв| перебирая  их  своими  щупальцами
отбросить вн| отбросил скучную газету
угадать вн| угадал  мою невысказанную мысль
выразить тв| словами, дорогой Уотсон, но  бровями  выразили  несомненно
удовлетворён тв| удовлетворен таким объяснением
служить дт| служат вам
отсутствовать тв| отсутствующим видом
стать дт| стала  вам
отвлекать тв| отвлекать этим
прочесть вн| прочел  указанную  заметку
дочитать тв| дочитал  статью
дочитать вн| дочитал  статью
презреть вн| презреть жару
отправить вн| отправил  телеграмму,  и  Лестрейд
вышивать вн| вышивала  салфеточку для кресла
вносить вн| эту пакость  вносили  сюда
вынести вн| вынес желтую картонную коробку, кусок
передавать дт| передавал ему
просмолить рд1| просмоленного шпагата
разрезать вн| разрезала веревку
отправлен тв| отправлена мужчиной
отрезан тв| отрезаны тупым инструментом
таиться тв| решительным  вступлением  таилось
звать вн| звать  полицию
глядеть тв| глядя  невидящим  взором  поверх садовой ограды
впиться тв| впился глазами  в  ее  профиль
узнать вн| узнать причину его
перестать дт| перестала нам
побеспокоить дт| побеспокоить  по  делу
выслать вн| вышли на улицу
надвинуть вн| надвинув шляпу на нос
приказать дт| приказал ему
советовать дт| Советую вам
купить рд| шиллингов  купил
подержать тв| подержанными    вещами    на  Тоттенхем-Корт-
пробежать тв| пробежал  глазами
представлять вн| представляет  известную  трудность
беседовать тв| беседовали  вечером  в  нашей  квартире  на  Бейкер-стрит
сделать дт| сделать  карьеру  в  Скотленд-Ярде
погрести пр1| погребенной на  дне  сейфа
делать тв| делая их достоянием  широкой  публики
соблюдать вн| соблюдать известную сдержанность и осмотрительность
обкурить тв| дочерна обкуренной трубкой, справочниками и другими
посасывать вн| посасывая  трубку
связать пр| манере связали с Медными буками
пожимать дт| горячо  пожимая ему
черкнуть вн| черкнул  записку
купить вн| купил практику
купить дт| купил практику
стёрт тв| стерты  подошвами
закрутить тв| закрученными усиками
лишиться рд| этого места лишусь
лопнуть тв| Гарденсе, но  весной этого года  лопнул
истрепать вн| истрепал  всю обувь
послать рд| послал  им
послать дт| послал  им
получать тв| вдруг  обратной  почтой получаю
совать вн| просто  сует  руку  в  кучу заявлений
курить вн| курил  трубку
подавать вн| подает  визитную  карточку
попросить вн| попросил  хозяйку
войти рд1| Вошел среднего роста
войти рд| Вошел среднего
лосниться тв| лоснящимся носом
составлять тв| фирмы  целиком составляют
подыскать дт| подыскать  ему
написать рд| Напишу им
написать дт| Напишу им
делать рд| этого делать
найти дт| что нашел брату
сопутствовать дт| всегда сопутствует вам
обрадоваться дт| обрадовался этому предложению
взволновать тв| взволнованный блестящей перспективой
назначить рд1| назначенного срока
последовать дт| последую его совету
заведовать тв| заведовать  большим  филиалом  нашей  компании  в  Париже
распространять вн| распространять английскую керамику
выписать тв| выпишите  всех  торговцев  железоскобяными изделиями с их адресами
обуревать вн| душу  мою  обуревали  самые  противоречивые чувства
недооценить рд| недооценил  трудностей
наложить вн| плохо наложенную золотую пломбу
сунуть вн| сунул голову в таз с холодной водой
деть рд| тут  дело
деть тв| В  тот  же  день  вечерним поездом
увидеться тв| утром увидеться  с  Шерлоком  Холмсом
искать вн| ищете работу
развернуть тв| развернутой газетой
исказить тв| искаженное  таким  страданием
злоупотребить тв| злоупотребить вашим терпением в такой степени
прерван тв| прерваны  резким  стуком
отворить тв| отворил  ее  рывком
развязывать вн| развязывать  резиновую петлю
распростереть тв| распростертым  телом
расстегнуть дт| расстегнул ему
смочить тв| смочил  холодной  водой
вздохнуть тв| вздохнул наконец всей грудью
вызывать вн| вызывать полицию
стать рд| им стал
назвать рд| названного банка
понадобиться тв| им  понадобился
понадобиться рд| им  понадобился
проиграть вн| проиграет  игру
бояться дт| бояться ему
поручить дт| где  поручили  вам
приглашать рд| Приглашать третьего
не хочется тв| им не хотелось
не хочется рд| им не хотелось
не хочется дт| им не хотелось
изменить тв| второй изменил
затрясти тв| затряс сжатыми кулаками
дерзить рд| держат специального сторожа
растирать вн| нервно  растирали  широкую   красную   полосу
развернуть вн| развернул  газету  на  столе
избавить вн| избавить полицию  от  лишних  хлопот
грозить дт| что  тому грозит
запирать вн| как запирали входную дверь
выколачивать вн| выколачивать  трубку
повесить вн| повешу свою шляпу  на  свободный  крючок
вручить дт| вручил ему
отразиться пр| на лице отразился
поехать тв| Поедем  поездом
упустить рд| упустить ничего
командовать рд| им командовал
командовать дт| им командовал
начать вн| начал  службу
стирать вн| вдруг стирала улыбку  с его губ
заметить тв| замеченная  сослуживцами
квартировать рд| полка "Роял Мэллоуз" квартировал уже несколько
занимать дт| занимал виллу Лэчайн
раздавать дт| раздавало беднякам
значить тв| значащими словами
чаять вн| чашку  чаю
отпереть тв| делом  отпереть
валяться рд1| валялась необычного вида
открывать дт| открывать местному слесарю
припомнить вн| припомнила  одну  важную  подробность
раздражить дт| по их раздраженному тону
наносить дт| наносит ему
объяснить рд| легко  объяснили тем
вызвать тв| вызванного нервной лихорадкой
занавесить тв| занавешенной портьерой
удариться тв| ударившись  затылком  об  угол  каминной  решетки
расстроить пр| расстроенных чувствах
предполагать тв| предполагаемым признанием
повернуться тв| потом повернулась  ко мне с решительным видом
сгорбить вн| сгорбленного мужчину
идти дт| шел нам
падать рд| от  фонаря  падал
закричать тв| закричал душераздирающим голосом: "О, Боже, ведь  это  же  Нэнси!"
сказан тв| сказаны таким тоном
преследовать рд| до  сих  пор  преследуют
потрясать тв| яростно потрясал  сжатыми  кулаками
умолять дт| умолять никому
разыскать вн| разыскать  человека,  появление
очутиться тв| образом  очутилось на свободе
требовать рд| как требовать его ареста
стоить пр| Возле его дома стоит на часах один из моих мальчишек  с  Бейкер-стрит
пылать дт| пылавшему камину
пасть тв| пал жертвой самого провидения
вышибить дт| вышиб ему
обагрить тв| обагрил руки его кровью
умереть пр| умер на днях
кончиться рд| на вторую неделю осады у нас кончилась  вода
пробиться тв| пробиться со всеми женщинами и детьми
одолеть тв| ползком  одолел  первый  поворот
читать вн| просто, как читаю сейчас вон ту надпись над камином
улизнуть тв| образом улизнул
выдвинуть вн| выдвинул переднюю стенку
сыграть вн| сыграл  выдающуюся роль
исчисляться тв| исчисляются  сотнями
оборваться тв| неожиданно оборвавшееся трагедией
снискать дт| снискавший моему  другу
заслужить вн| заслуженную  славу
сосредоточить вн| сосредоточенную работу мысли
рассматривать вн| рассматривать ее руку
опускать вн| опуская ее руку
повернуть тв| Холмс мягким движением повернул  ее  лицо  к  свету
прилизать тв| прилизанными волосами
оборачиваться тв| все  оборачивалось наилучшим образом
омрачить вн| омрачившим мою жизнь
хвалиться тв| без  конца  хвалился своим богатством
объявить дт| объявила  ему
подвергнуться дт| подвергнусь подобному унижению
представить вн| представить  более  пустынную местность
встретить вн| редко встретишь телегу
увидеть пр| увидела на расстоянии
заказать вн| что заказал лошадь и легкую рессорную
аккомпанировать дт| ему аккомпанирую по  вечерам
обмолвиться пр| обмолвился  ни  о  чем
увенчан рд| столба увенчаны
позеленеть тв| позеленевшими дворянскими  гербами
спрыгнуть рд| спрыгнул  с  велосипеда
рулить дт| самому  рулю
ринуться дт| ринулась ему
покинуть рд| покинул своего убежища
воплотить тв| воплощенной любезностью
подвергаться дт| в  любое  время  подвергался  нашествию
симпатизировать дт| симпатизировала  ему
верить тв| верил им
верить дт| верил им
верить рд| верил им
обтянуться пр| кости на лице обтянулись
велеть дт| велю вам
руководить тв| руководит мною
доказать дт| докажу вам
поворачивать рд| поворачиваемого  ключа
прерываться тв| прерывающимся голосом
закрыт тв| почти закрыто одеялом
лежать пр| полке  лежали в беспорядке трубки, кисеты с  табаком
лежать пр1| полке  лежали в беспорядке трубки, кисеты с  табаком
зажать вн| зажав коробочку в руке
сдержать дт| сдержанному Холмсу
подавить пр| В  самом  подавленном настроении
приехать дт| приехал  по  делам
смягчить тв| Любыми средствами смягчите  его
препятствовать дт| препятствуют их размножению
затянуть тв| высоким, тонким  голосом  затянул
произвести рд| произвели  должного  впечатления на  мистера
воскликнуть тв| воскликнул Смит настойчивым тоном
воздавать тв| Воздаю  добром за зло
воздавать пр| Воздаю  добром
заразиться тв| заразился этой редкой азиатской болезнью
усмотреть вн| усмотреть причину и следствие
остаться рд| останется ни одной улики
говорить тв| говорил  своим  естественным  голосом
сопровождать тв| сопровождаемая звяканьем  железа
болеть тв| криком боли
приносить дт| приношу вам
утолить вн| утолил  жажду
жаждать тв| жажду  стаканом  кларета
устранён тв| устранено губкой
создать вн| неплохо создал иллюзию бреда
трогать вн| трогайте эту  коробочку
раскрыть вн| коробку раскроешь
раскрыть дт| коробку раскроешь
претить дт| Этому угрюмому скептику претили
сменить вн| наконец сменить обстановку
обещать рд| обещая  им
обещать тв| обещая  им
обещать вн| обещая  им  покой  и  защиту
расстилаться тв| Кругом расстилалась
разбросать тв| разбросанными там  и  сям  могильными  курганами  и  любопытными земляными
выписать вн| выписал  кучу  книг  по  филологии
лепиться рд| сотни-другой жителей лепились вокруг  древней  замшелой церкви
предложить тв| знаком   предложил
позабавиться дт| в  душе позабавился тому  изумлению
нагнать вн| в направлении  дома  своих родственников, и тут его нагнал шарабан доктора Ричардса
застыть пр| на  лицах  застыл
отражаться пр| глазах  отражается
убить вн| моих братьев, страх убил
убить дт| страх убил Брэнду
лишаться рд| лишаются рассудка
произойти пр| начале  произошел
вытаращить тв| вытаращенными  глазами
облить дт| облив нам
слышать тв| слышала  ночью
зайти тв| когда  зашла утром в комнату
окликнуть вн| окликнула  фермерского мальчишку
обойти тв| легкими,  быстрыми шагами  обошел
топить тв| весной топят в такой  небольшой комнате
завязан дт| завязан  вам
сослужить вн| сослужили свою службу
засыхать тв| засыхающим  побегом  дерева
помочь рд| поможем им
начинаться пр1| мире  начинается
начинаться пр| мире  начинается
высказать вн| Единственную догадку высказал
писать вн| пишет  монографию
красться дт| За  доверчивой,  набожной  женщиной  крадется   по   пятам
терзать вн| хозяйку ее неотступно терзает мучительный страх
разыскивать вн| разыскивал горничную
вывести рд| вывела  уже  немало  образцовых экземпляров
прокусить дт| ему прокусили
заложить рд1| Заложил ее высокого роста
состарить пр| Горе  состарило  его
задать рд| задали ни одного вопроса
принести вн| принесла  подвеску
охватить вн| охватившее  пламенную  душу
предпринимать рд| ничего предпринимать
отнести вн| это отнести мою записку в  полицию
убить тв| тем временем убьют
заручиться тв| сейчас заручится поддержкой  закона
восстановить вн| восстановить всю картину
заманить вн| заманили  несчастную  женщину  в  Лондон
писать дт| писала кому-
охотиться рд| охотились  с  самого  начала
умертвить тв| умертвили настолько  необычным  способом
блюсти вн| педантично  блюсти  букву  закона
придержать тв| придержал ее ботинком
войти тв| неслышным  шагом  вошел
обвиснуть тв| обвисшими щеками
преувеличить тв| преувеличенным  добродушием, с которым никак
искать рд| до тех  пор  искать
удовольствоваться тв| пока удовольствоваться этим
вздумать дт| вздумайте нам
прибавить рд1| прибавил  света
превратить вн| превратить все еще красивую, цветущую женщину
смениться пр| на  лице  Холмса  сменилось
сфотографировать вн| сфотографировать  вашу  физиономию
ворваться тв| силой ворвались  в  мой  дом
ввалиться тв| ввалившимися щеками
осадить вн| минут  кэбмен  осадил взмыленную лошадь возле крыльца
преградить рд| преградил им
преградить тв| преградил им
преградить дт| преградил им
упереться тв| упершись рукой в грудь первого носильщика
сорвать вн| сорвали крышку
обложен тв| обложена  толстым  слоем  ваты,  пропитанной наркотиком
задушить рд1| хлороформа  задушили
задушить вн| задушили  последнюю  искру  жизни
примереть рд| пример  временного  затмения
придать рд| придал должного значения
установить вн| установить причину
усыпить тв| усыпили  ее  хлороформом
завинтить вн| завинтили  крышку
пережить пр| недавно пережитом большом потрясении
увит тв| увита плющом
проломить дт| проломили  ему
выпалить вн| долю  выпали
смачивать тв| усердно смачивала водой с уксусом
отделать тв| отделанное блестками
упасть рд| ее  халата упали, обнажив руки до локтя
сковать тв| скованной  такими  условностями
разрешиться тв| разрешилась бурными рыданиями
задёрнуть тв| задернутым плотными портьерами
отдёрнуть вн| отдернула портьеру
завязан тв| завязан  платком
поговорить тв| Поговорив шепотом о чем-то
освободить рд| освободить рот
послушать рд| рад послушать ваш рассказ
забрызган тв| забрызгана  мозгами  и  кровью
пасть рд| пасть большого, глубокого камина под массивной дубовой  полкой
запрокинуть тв| запрокинутым лицом
облить тв| облил керосином
привязать дт| которым  леди  привязали  к  креслу
услышать рд| услышит звонка
заподозрить вн| заподозрить служанку
послужить дт| послужили  грабителям
темнеть пр1| на дне темнел
перемениться пр| на глазах переменился
открывать вн| открывали бутылку
пробуравить вн| пробуравил  пробку
вытащить рд| вытащил ее с первого
давать рд1| дает  покоя
победить тв| побежденный  сомнениями
скрыться рд| нашего поезда скрылись за поворотом
клясться тв| клянусь жизнью
противопоставить дт| противопоставить этому
бить вн| бить  женщину
ограничиться тв| ограничатся  пустяками
наполнить вн| как  наполнили  второй  бокал, бутылку
лгать дт| нам  лгали
скрыть рд| скрыть настоящего
заниматься рд1| часа  занимался
опереться тв| оперся коленом на карниз стены
совершить рд| совершил  самой  большой  ошибки  в  моей  жизни
погнуть вн| погнул кочергу
придуман дт| придумано им
придуман тв| придумано им
придуман рд| придумано им
протереться пр| месте протерся
хватить рд| хватило ума
кончаем тв| кончаем победой
кончать тв| кончаем победой
выслушать тв| добродушной   готовностью  выслушать все, что
скрыть вн| скрыть свою  ненависть  к покойному хозяину
выругать вн| при  мне  выругал госпожу
бросаться тв| бросался  графинами
обижать вн| обижал  мою  славную  птичку
прикинуться тв| прикинулся таким  ласковым
менять вн| менять примочку на лбу
причинить дт| причиню  вам
связывать вн| связывающая Южную Австралию с Англией
назначен тв| назначен  капитаном  на  судно  "Бас  Рок"
наделён тв| наделены сверхъестественными способностями
допустить вн| просто допустил такую возможность
арестован пр| Йорке  арестована
совершить тв| минувшей ночью совершить
распахнуться рд| нашей   комнаты  распахнулась
опалить тв| опаленной  тропическим  солнцем
играть рд| Нечего играть со мной в кошки-мышки
явиться тв| явились его следствием
находить рд| нахожу так много удивительно интересных дел
записан тв| записаны  мною
приехать рд| приехали с юго-запада
добиться рд| добьетесь успеха
обеспечить тв| вполне  обеспеченным  человеком
соединить пр| Соединенных Штатах
покидать рд| покидал своей комнаты
увидеть рд| увидел ничего
оплачивать тв| всегда оплачивал наличными
пользоваться рд| пользоваться им
пользоваться дт| пользоваться им
подписать вн| подпиши бумагу в том
взглянуть дт| взглянув ему
находить рд1| находил покоя и был
ответить дт| Отвечу  вам
приказан дт| ему приказано
наводить рд| наводящих  подробностей
избежать тв| таким   образом   избежала
складывать вн| складывая  бумагу
возвращать дт| возвращая  ее  нашему посетителю
описать тв| описанную вами
сожжён тв| сожжены вашим дядей
решать дт| решать моему другу
обезуметь тв| обезумевшим  полковником  Уорбэртоном
бывать тв| на  железной дороге редко бывают  пустячными
продолжать тв| шепотом продолжал
обвязан тв| обвязана носовым платком
узнавать рд| начал узнавать в  Паддингтоне
налить дт| налил ему
овладеть рд| Им овладел один из тех  истерических  припадков
овладеть дт| Им овладел один из тех  истерических  припадков
порозоветь рд| щеки порозовели
нанесён тв| нанесена тяжелым и острым инструментом
обработать вн| обработал рану
укутать вн| затем  укутал  руку
выкладывать вн| выкладывать всю историю в  полиции
подтвердить тв| ничем  подтвердить ее
рекомендовать дт| настоятельно рекомендую вам
набивать тв| набивая всякими остатками
собираться тв| тщательностью  собирались
усадить рд| усадил  нашего  нового  знакомого
подложить дт| подложил ему
поставить тв| рядом  поставил
слушать вн| слушать  действительно  невероятную историю
изложить пр| изложил во всех подробностях
унаследовать вн| унаследовав солидную сумму  денег  после  смерти  отца
выполнить вн| выполнить одну небольшую работу
указать вн| указать точную дату
пожаловать дт| пожалованного  ему
вынуждать рд| доверенного  лица  вынуждает  меня
предоставляться дт| вам  предоставляется
подвергнуть дт| подвергнуть допросу
рассказывать рд| ничего рассказывать
покрыть рд| Покрой плеч
успокаивать тв| успокаивающим тоном
заходить тв| утром захожу  к  старику
внушить дт| внушить кому-
создавать рд| начал создавать свой  метод
половить вн| половить  рыбу
обветрить тв| обветренным лицом
разогнать вн| разогнали шайку браконьеров
копать вн| часто копали землю
сбрызнуть дт| сбрызнули  ему
навести рд| моих  способностей  навела меня
думать пр| думать  ни  о  чем
таиться дт| прежнему таился
втащить вн| втащить рыбу в лодку
подавать рд1| подавал вида
доказать вн| доказавший всю важность
заискивать тв| заискивающим  видом  и косолапой походкой
питаться тв| все еще питаюсь солониной из бочек
ошеломлён тв| ошеломлен этой новостью
помять рд| Помните  того  субъекта
помнить рд| Помните  того  субъекта
быть рд1| было  ни  одного  спокойного часа
присвоить дт| присвоил  ему
увеличить тв| увеличил  им
увеличить дт| увеличил  им
увеличить рд| увеличил  им
сшибить рд| сшиб его с  ног
выражать вн| выражали угрозу
парализовать тв| Потом его всего парализовало
меркнуть пр1| меркнущем солнечном  свете
послужить тв| послужило причиной его смерти
выдать вн| выдаст некую тайну
подвинуть вн| подвинул лампу к  краю
удаваться дт| моряку  Хадсону  удавалось
омрачить рд| бесчестья омрачила  последние  годы  моей жизни
ждать вн| ждал каждую минуту
материть тв| матери  и  нашей взаимной привязанностью
лишить тв| лишенным  растительности  лицом
доставать дт| доставал ему
наслать рд| денег так и не нашли
проговорить тв| громким шепотом проговорил
суметь рд| сумеешь кое-
возблагодарить вн| возблагодари судьбу
выражаться рд| манера выражаться
подкупить вн| подкупить команду
наставить рд| дабы  наставить нас
заткнуть дт| заткнул  ему
дымиться тв| дымящимся  пистолетом в руке
ударить дт| ударил нам
наполниться тв| наполнилась  таким густым дымом
открыться дт| глазам нашим открылось
привозить рд| до сих пор приводит
выстрелить дт| выстрелил ему
затмить тв| своими  более  пикантными подробностями затмили
затмить вн| затмили эту драму
усесться пр| Удобно усевшись в одном кресле
пресытить тв| пресыщенный злободневными новостями
испачкать тв| испачкать чернилами
нанять тв| нанятый  мистером
припомнить рд| припомнить  ни  одного  случая
замалчивать рд| смысла замалчивать
выпроводить вн| выпроводить  эту  особу
надеть вн| надела шляпу
привозить дт| приводят  к  совершенно  невероятным  результатам
выделяться тв| выделялся силой интеллекта
завязывать вн| завязывать  новую  дружбу  были
обязан дт| обязаны систематическому упражнению
познакомить рд| рад  познакомить вас
кончаться тв| кончалось размышлением в покойном кресле
доказывать вн| доказывать свою  правоту
зайти рд| Рождества зашел
лежать рд| стула лежали
толочься рд| миллиона  человек  толкутся  на  площади
хотя рд| хотя ничего
содержать рд| содержат ничего
рассечь тв| рассеченной губой
размахнуться тв| размахнулся  палкой
испугать рд| испуганный  тем
определить пр| определенном отношении
висеть тв| висевшего рядом  пальто
вернуть дт| вернул  ему
надраить рд| идеально  надраенных  туфель
заполнить тв| заполнил собой
раскурить вн| раскурить мою трубку
готовиться пр| на  глазах  готовится
сознавать тв| со  всей  ясностью  сознавать
оказаться дт| человеку оказаться в более тяжелом положении
заверить вн| заверить  этого  человека,  что  его  сиятельное  имя  ни в коем случае
заверить рд| заверить  этого
двигать тв| Им  движут  в  высшей   степени  достойные
двигать дт| Им  движут  в  высшей   степени  достойные
двигать рд| Им  движут  в  высшей   степени  достойные
изложить дт| изложу вам
открыться рд| открыться до  конца
оплатить вн| оплатили  поездку
бредить тв| бредит  им
бредить дт| бредит  им
бредить рд| бредит  им
слушать рд| слушать ничего
выдать дт| невольно  выдали нам
противостоять дт| противостоять натиску
заняться рд| им заняться
заняться дт| им заняться
следовать рд1| следует  с  другого бока
оказываться тв| зачастую оказывались жизненно важными
предпринять тв| предпринятые  Холмсом
загружён тв| загружен срочной работой
причинить тв| причинить им
причинить рд| причинить им
сдерживать рд1| сдерживаемого хохота
разразиться тв| разразился вежливым смешком
удалиться тв| удалился  со  всем  доступным
остаться тв| на всю жизнь остался калекой
взмахнуть тв| взмахнул  рукой
желать дт| желаете  нам
вцепиться тв| яростно  вцепилась руками в воздух
приспичить дт| ему приспичило
вперить тв| своим бархатистым голосом, а потом вперит в  меня
кичиться тв| кичится своей коллекцией
временить тв| времени  даром
забираться дт| взломщику забираться туда
утащить вн| Разве  что утащит всю эту диковинную посуду
заявить тв| твердым  тоном  знатока  заявил
пораскинуть тв| тем   временем  пораскину
устроить вн| устроить личную встречу
швырнуть рд| Швырните этого
втоптать вн| втоптать туда его проклятую  физиономию
изменить пр1| несколько  измененном  виде
передать тв| передать  более  простыми словами
олицетворять тв| олицетворяет собою
заграбастать тв| заграбастать  своими   мерзкими  лапами
возвысить дт| возвышенным помыслам,  Уотсон
отрешить пр| отрешенных глазах
вспомнить рд| вспомнил  слова этого  негодяя  о  постгипнотическом  внушении
открыть рд| уже открыл рот
закончить вн| закончить нашу  беседу
уступить дт| уступила  желанию отца
почувствовать вн| вдруг почувствовал невыразимую злость
спасти вн| спасти эту женщину
напечатать вн| Афишу  напечатали
листать вн| листая  газету  в  поисках  роковой  заметки
затемнить вн| затемненную  комнату
забинтовать вн| забинтованную  голову
просочиться тв| багровой  полоской просочилась сквозь  белую полотняную повязку
понурить вн| понурил  голову
вооружить тв| вооруженным палкой
удалить дт| Велите  Шинвелу  Джонсону  удалить
удалить вн| удалить  девушку
продумать вн| продумаем нашу  кампанию
подозревать тв| временами подозревал
привозить рд2| характеру  этого  человека,  не  раз  приводили к  театральным эффектам
набить тв| набитые документами
опасаться рд| опасаться  нечего
порыть дт| Порою ему
проявить рд| возможностей  проявить
пыхать тв| пышущая  здоровьем
сдавать дт| сдают жильцам
повести тв| повел  рукой  в облаке дыма
ждать дт| часам ждите нас у себя в Брикстоне
метнуться тв| молнией  метнулся  к  груде  толстых тетрадей в углу
перелистывать рд| перелистываемых страниц
раскидать рд| раскиданных тетрадей
изодрать тв| так изодрал когтями ее
отогнать тв| шестами  отогнали
настигать рд| прыжков настигает
сбивать рд| сбивает ее с ног
впиваться тв| впивается зубами
отпереть вн| отпер клетку
поведать дт| нам поведала
отплатить тв| странным  образом  отплатила
поломать пр| поломанном  кресле
очертить рд| очерченный  рот
солгать дт| ему солгала
сообщить пр| долгом сообщить
скрежетать тв| скрежещет зубами
пускать вн| как пускает пену
вонзаться тв| с  какой неистовой злобой вонзаются
понять вн| понять мою историю
полосовать тв| полосовал  хлыстом
кончиться тв| кончилось трагедией
прокрасться тв| тихонько  прокрался  следом
подсказать дт| вмиг  подсказало льву
обжигать тв| Под его обжигающим смрадным дыханьем
услышать вн| услышать такую историю
забрызган пр| местах забрызган
заключаться рд| моего положения заключается в  том,  что мои страхи
разорить вн| разорил семью
возвратиться тв| потом  возвратился  в  Англию
разочаровать тв| разочарованным человеком
наладить вн| наладить  там  медицинскую практику
затевать вн| всякий раз затевал безобразную ссору  с  первым
позволять тв| позволяет  этим
раскидывать дт| бродягам раскидывать
кочевать тв| порой  кочует  вместе  с  ними
присылать дт| присылает ему
сообщаться тв| сообщаются  между  собой
беспокоить вн| сестру мою долго беспокоил
выносить рд1| выносила  этого  запаха
охватить рд| неотвратимого  несчастья охватило
поразить тв| пораженная ужасом
подогнуться рд| сестры подогнулись
сводить тв| сводило судорогой
забыть рд1| забуду ее страшного голоса
исчезнуть рд| совершенно исчез с моего  горизонта
беречь пр| месте берег
заливать тв| заливаемого  водой
иметься пр| местах имеются
заполняться тв| с  каждым  приливом заполняющиеся  свежей  водой
дуть рд| дул с  юго-запада
набить дт| набитому карману
перенести рд| перенесенного ревматизма
располосован тв| располосована темно-багровыми рубцами
исхлестать тв| исхлестали  плетью из тонкой проволоки
назван тв| назван  иначе,  как  дикими
известить вн| немедленно известите полицию
отступить тв| отступившим приливом
раздеться рд| этой лагуны Макферсон разделся
кружить пр| Кружа  во  всех  направлениях по твердой гальке
исхлёстан тв| необъяснимым  и  нечеловеческим  способом  исхлестан
достать рд| него  еле  достало сил
сулить рд| сулил  успеха
путать рд| путать следов
обыскать тв| временем обыскал
вложить вн| вложил записку
назначить дт| назначила ему
славиться тв| славится своей красотой
опоясывать тв| полукругом опоясывающей
опоясывать вн| опоясывающей бухту
подчинён дт| подчинен вам
подвернуться тв| подвернувшимся предлогом
рыжеть тв| с   огненно-рыжей  бородой
компрометировать рд| компрометировало Мод
замешивать рд| никаких оснований замешивать в эту историю
исполнить тв| исполню этим
сосредоточить тв| сосредоточенным вниманием
доказать рд| тем доказав
оглашать рд| оглашали  нашей  помолвки
проворчать тв| проворчал Беллами
обыскать вн| негласно обыскать его комнату
запомнить рд| запомнит  случая
поощрять вн| поощрять подобную  болтовню
подохнуть рд| Подохла с тоски по хозяину
объяснить тв| объяснить  преданностью и верностью всей собачьей
всеять рд| всей собачьей породы
выдавать вн| выдавали  страшную муку
проноситься тв| вихрем проносились
завалить тв| заваленный  книгами
вынырнуть тв| вынырнул  с  небольшим  томиком шоколадного цвета с серебряным обрезом
проглотить вн| проглотил  утреннюю чашку
окружать рд| окружала этого
смочь рд| сможет без труда
иметь тв| Потом имейте
подвести тв| кратчайшим путем подвести нас к раскрытию виновника убийства
целиться тв| целился костлявыми  пальцами  за  стулья
загородить тв| загородил  собой
брать тв| четверкой берет
двигаться тв| двигающейся следом массивной фигурой
задёрнуть вн| тщательно  задернул  тяжелую оконную штору
отбыть тв| вместе  со  всеми  домочадцами  отбыла  в  Флиссинген
предоставить вн| предоставит  Францию ее собственной  участи
заварить вн| заварили такую адскую кашу из  гражданской  войны в Ирландии
решить вн| решить судьбу  Англии
обшить тв| обшитой  дубовой  панелью
распахнуть вн| над  замком распахнул тяжелую дверцу
приглашать тв| жестом  приглашая  гостя
набит тв| набиты  документами, чертежами  и  планами
похлопать тв| громко похлопал мясистыми ладонями
увенчать вн| увенчать мою коллекцию
проведать тв| образом  проведало
забить вн| забило тревогу
выразить вн| выразившее досаду
пододвинуть дт| пододвинул  ему
обозначен тв| обозначено  терминами  автомобильных деталей
объявить вн| объявил войну
пронести вн| пронести папку  с  сигнальными  кодами  под  самым  носом
потушить вн| потушила лампу
кидаться тв| кидаясь бегом
прожечь тв| прожженную кислотой
улыбаться пр| улыбающемся  лице
окружать вн| окружавшую таинственную фигуру
поглощён рд| поглощен им
нарядиться тв| сегодня нарядился старухой
отделять вн| отделявшую  комнату  от  оконной ниши
придумать вн| придумать лучшую шутку
презирать вн| презираете мой жалкий табак и трубку
обременить вн| обременить  свою  память
добавиться дт| старым порокам добавился еще
загруженный тв| загруженный работой
отбрасывать вн| отбрасывая в сторону страницу с объявлениями
усвоить вн| хорошо усвоили эту  истину при изложении
подхватить тв| подхватив  щипцами
раскуривать вн| раскуривая  длинную  трубку  вишневого  дерева
отдавать дт| отдаю  вам
пылать рд| пылавшего камина
расплыться тв| расплывшимися пятнами
утерять рд| по  розыску  утерянных  карандашей
спускаться тв| подбородком,  тяжелыми складками  спускавшимся  на  грудь
ссужать дт| ссужать юным леди
моргнуть тв| глазом моргнуть
унижать рд| унижать вашего достоинства
занять вн| просьбу  занять
нашить рд| нашей краткой беседы
сообщить тв| Сообщите каким поездом
скроить вн| скрою дату
завладеть тв| Завладев их тайной
улыбаться тв| улыбающейся  физиономией
запасти вн| запас карту
уложить тв| сгоряча уложившего дубиной своего товарища
терзать дт| не спеша терзает душу
набить пр| набитые золотом
парировать рд| парировать его ударов
отражаться рд| ее  верхнего  фонаря  отражался  на  блестящих  крупах
выйти рд1| из кареты вышел низкого роста
протянуть тв| протянутой пухлой ручкой
избежать рд1| избежать скандала в таком щекотливом деле
заплясать пр| глазах  заплясали
наказать вн| строго  наказал  леди  Еву
прижаться тв| прижался спиной к стене
вскочить тв| Затем резким движением  вскочил  на ноги
помиловать зв| Господи помилуй
покадить вн| покажу спину
покадить дт| покажу спину
оканчиваться тв| оканчивающаяся  позором
любить рд| люблю опрометчивых поступков
добыть рд| добудем писем
делить вн| делить камеру
исполниться дт| ему исполнился
насладиться тв| насладиться  отдыхом  после  долгих
сделан тв| сделаны  его  рукой
похвастаться тв| похвастаться  внешней  привлекательностью
прихватить вн| прихватила шкатулку старика
сыскать вн| сыскать  беглянку
создаться пр| создавшемся положении  вещей
собрать дт| собранные  по  свежим  следам
указать тв| кивком  указал
сгорблен рд| Спина его сгорблена
изрезать тв| изрезанного  глубокими морщинами лица
повиноваться дт| повинуясь  велению природы
возрастать тв| возрастающим интересом
разорвать вн| При  мне  разорвал  фотографию
приобретать тв| минутой приобретает совсем иной характер
броситься дт| бросилось вам
податься дт| подадимся наслаждению
нацарапать вн| нацарапанную записку
занять тв| занятый своими мыслями
представлять рд| представляла  такого  широкого  поля  деятельности
угрожать дт| угрожают историку
сыграть тв| сыгранная моим другом в деле
повеять тв| повеяло  прохладой
побродить дт| нам побродить по Лондону, Уотсон
просить рд| просить  нашего  совета
бросить рд| бросил исследовательской работы
упомянуть тв| упомянутую вашим другом
отрицать рд| этого отрицать
снят тв| снят  одним  человеком
умереть тв| умер этим  утром
заперт рд| Ворота  заперты  на  щеколду
плеснуть дт| плеснула  ему
ввязываться рд| смысла ввязываться в эту историю
отдать дт| отдать  ему
заплыть тв| заплывшие жиром
разделять вн| разделяете  мою  любовь ко всему необычному
изображать вн| из  ваших  рассказов изображают мою деятельность
приукрасить пр1| несколько приукрашенном виде
скомкать вн| скомканную газету
пробегать тв| пробегал глазами
красоваться пр| жилете красовалась
разглядывать рд| разглядывал этого
отгадать рд| отгадать  ничего
отрывать рд| отрывая  указательного  пальца от газеты
мочь пр| ином может свидетельствовать
окрашивать вн| окрашивать рыбью чешую
отгадывать тв| какими мудреными способами отгадываете
адресован дт| адресована Шерлоку Холмсу
перечитывать вн| перечитывая телеграмму
посадить пр| глубоко  посаженных глазах
благословлять рд| благословлял этого
нарушить тв| нарушившего своей  загадочной телеграммой
возвестить пр| прибытии  возвестила
задевать тв| Задевая плечами
положен дт| ему положено
выслушать вн| с живым интересом выслушал эту длинную горячую речь,  каждое  положение
подкрепляться тв| подкреплялось  энергичным  ударом  мускулистой  руки  по  колену
дотянуться тв| дотянулся  рукой  до  картотеки
обмануть рд| разнообразных сведений обмануло
удивиться дт| удивиться посетителю
не говорите пр| ни о чем не говорит
усилить рд| усиленных  тренировок
броситься тв| бегом бросились
подводить вн| подводить  команду и капитана
подводить пр| правилах  подводить  команду и капитана
мелить тв| суставами  мелить
сжать вн| сжав  голову
подать дт| подал  руки  посетителю
разобрать тв| фразами, портье разобрал
дежурить тв| дежурите днем, не так ли
писать тв| писал карандашом
разрушить рд| разрушило  немало  счастливых  браков
послан дт| кому  послана
пойти дт| пойдут  нам
переворачивать тв| переворачивал  быстрыми
изучать тв| изучая их живым, проницательным взглядом
расшибить вн| расшиб ногу
развязаться тв| развязавшимся белым галстуком
заплатить дт| заплачу вам
заплакать дт| заплачу вам
бросать рд| бросал денег на ветер
собираться рд| собираюсь этого
сверкнуть пр| глазах сверкнул
предать вн| предаст своего дядю
благодарён дт| вам благодарен
повезти рд| что  повезет с первого
подъехать дт| кучеру подъехавшего к нам
расшевелить рд| расшевелить этого
продемонстрировать дт| моему    другу  продемонстрировать
завален тв| завалена поздравительными  телеграммами
перепугать вн| перепугавшее всю  округу
затратить тв| затраченных ими
попасться тв| им попалось
попасться рд| им попалось
пропалить тв| пропали даром
пропасть тв| пропали даром
ворваться дт| нам ворвался
похитить вн| похитили ту чрезвычайно любопытную коллекцию
действовать пр| случаях действовало
лишить рд| почти лишило ее рассудка
совпадать тв| совпадает  со  временем
обхватить тв| обхватил руками
обхватить вн| опять обхватил голову
просидеть рд| минут  просидел  молча
залезть дт| нам залезть в карман к преступнику
поломать вн| поломать  голову
решать вн| решаете  любую  головоломку
свести тв| свело судорогой
осветить дт| освещенным  окнам
похитить рд| похищенных вещей
переживать тв| переживать Холмс любой
исправить вн| исправил  ошибку
вручить вн| вручил бумагу
вздуматься дт| ему  вздумалось
выложить тв| выложенной каменными плитами передней
набрякнуть тв| набрякшими  веками
сузиться тв| сузившимися зрачками
ограничиваться тв| всегда  ограничивались  одним  днем
мигать рд| мигающей  керосиновой лампочки
отыскать вн| отыскал  щеколду
замечать рд| тут замечал
велеть тв| вели беседы странными  низкими  монотонными  голосами
вести тв| вели беседы странными  низкими  монотонными  голосами
сидеть пр| стуле сидел
спать тв| рядами  спящих
одурять рд| одуряющих паров
оглянуться тв| потом оглянитесь
выпрямиться рд| Спина его выпрямилась
отказать дт| Трудно отказать Шерлоку Холмсу
выражен тв| выражены таким повелительным тоном
шаркать тв| неуверенно  шаркая  старческими   ногами
порассказать рд| порассказать много диковинных историй о том
передёрнуть тв| передернул плечами
определить рд| Определенных  занятий
предполагать рд| оснований  предполагать
привезти дт| привезет своему сынишке
помещаться рд| этого пароходного общества помещается на  Фресно-стрит
последовать тв| констеблями  последовал  за  миссис
удаться тв| им  удалось  проникнуть  в  ту  комнату
удаться рд| им  удалось
наполняться тв| наполняется водой
обнаружить вн| обнаружить всю одежду мистера Невилла
отрицать вн| отрицает всякую
удивляться дт| всегда  удивлялся тому
изуродовать тв| изуродованное чудовищным  шрамом
задеть тв| задеть его насмешливым словом
возмещаться тв| возмещается необычайной силой
оказаться пр| рукаве  его  рубашки оказались
поджидать рд| поджидать отлива
обнаружить пр1| обнаружить на дне
отхлынуть рд| Когда отхлынула вода
унести рд| унес пиджака
остаться пр1| остался  на  дне
выбросить рд| Бун  выбросил
слышать вн| слышит  суматоху  на  лестнице
замечен пр| дурном замечен
выбежать дт| выбежавшему нам
посыпать тв| посыпанной  гравием
осветить вн| ярко  освещенную  столовую
щадить рд| щадите моих чувств
смущён тв| смущен этим вопросом
рассматривать рд| рассматривая ее с разных точек зрения до тех пор
разбудить тв| разбуженный  его  внезапным  восклицанием
проверить вн| проверить одну свою версию
заколдовать пр| заколдованном городе
отдалить дт| отдали ему
отодвинуть вн| осторожно отодвинул дощечку
подобать дт| подобает людям его профессии
порвать рд| сквозь  прорехи  порванного пиджака
позорить вн| в самом  деле  позорит  нашу  тюрьму
намочить вн| намочил свою губку
убедить вн| убедить полицию
намалевать пр| намалевал на лице
подстроить вн| подстроил фокусировку
попросить дт| из Ярда попросил ему
набивать вн| набивая трубку
присылать тв| присылаемые  нашим  почтовым агентом, Холмс
уступать дт| уступает своему знаменитому отцу
считаться тв| считался  первым  фаворитом  скачек на кубок Уэссекса
допустить рд| допустить  появления Серебряного
предать тв| преданным  слугой
накормить пр| где их в  кухне накормили ужином
накормить тв| где их в  кухне накормили ужином
понести дт| понесла  ему
сторожить дт| ночному сторожу
нести дт| несете ему
испугать вн| испугало девушку
кликнуть вн| кликнула  служанку
броситься рд| им бросилась
сжимать вн| сжимала  маленький нож, по самую рукоятку в крови
подсыпать дт| подсыпал ему
показать рд| остатков  ужина Хантера показал
нанесён дт| тренеру были  нанесены
сдвинуться рд| иного  способа  сдвинуться  с  мертвой  точки
приобретать вн| Грегори,  чье  имя  приобретало  все  большую  известность в Англии
задавать дт| от времени задавая ему
вооружён тв| вооружен тяжелой тростью
продать дт| В какой аптеке продали ему
просить вн| просил служанку
желтеть рд| желтеющего  папоротника
убить рд| Карманы убитого
костить тв| из слоновой кости  и  очень  тонким  негнущимся  лезвием
уходить тв| уходя ночью, Стрэкер
оплатить рд| оплаченных  счета  за  сено
заброшен тв| заброшен  ветром  на  куст
улечься тв| Потом улегся на нее
подпереть тв| подперев руками
истоптать вн| истоптанную глину
осмотреть тв| все здесь  осмотрел самым тщательным образом
замахать тв| замахал  рукой
трястись пр| трясущихся  руках
описать дт| так  подробно  описал  ему
упоминаться тв| упоминавшихся  мною
напомнить дт| напомнил ему
сесть тв| сели рядом
утомить дт| утомленным лицам
просвечивать тв| просвечивающими  венами  руки  премьера
позволен дт| позволено никому
частить рд| части  дня
подкреплён тв| подкреплено    торжественным    предупреждением     со     стороны  премьер-министра
нахмурить рд| премьер  нахмурил густые брови
довериться дт| доверимся вам
полагаться тв| полагаюсь целиком на вашу скромность
обеспокоен тв| обеспокоен  недавним расширением колоний нашей страны
раскрыть пр| интересах раскрыть
завладеть рд| завладеть  им
завладеть дт| завладеть  им
хранить рд| никаких причин  хранить
подняться рд| поднялся с дивана
похищен тв| похищен  горничной   или  лакеем
возглавлять вн| возглавляют эту компанию
уезжать дт| ему уезжать
узнать дт| ему узнать
повидаться тв| повидаюсь со  всеми
доставить тв| доставленную вечерней почтой
достать тв| достал с полки  за  спиной
накопить тв| накопленных  им
накопить дт| накопленных  им
отшвырнуть вн| вскоре   отшвырнул   книгу
вбить рд| вбив  им
вбить дт| вбив  им
вбить тв| вбив  им
писан тв| писано им
писан рд| писано им
писан дт| писано им
дочитать рд| Дочитав до конца
построить тв| построенных  ими
признавать вн| редко  признавать  заслугу
обогатить тв| его этим сведением обогатил
целить рд| Цель этого письма
окончиться тв| окончились полной неудачей
случать тв| случай с Айседором Персано, знаменитым  журналистом и дуэлянтом
пресытить дт| пресытить  читателя  и  тем  самым
относиться дт| числу относится
пахнуть тв| пахнет сенсацией
забыть дт| забыл вам
перенять вн| перенял  вашу  привычку,  Уотсон
следовать тв| когда  следует  любым путем
расследовать тв| талантом  расследовать  самые  сложные  дела
чувствовать рд1| привычного  беспорядка  Холмс  чувствовал
прибыть рд| текста прибыли из типографии
обит тв| обиты  зеленым  сукном
сопровождать вн| сопровождающую   акулу,   или  шакала,  бредущего за львом
создать тв| созданной  этим  необыкновенным  человеком
посылать дт| ему посылал
добиваться дт| добиваться разъяснений и тем самым
навлечь дт| и тем самым  навлеку на него
разжечь вн| разжег  трубку
распространить вн| очень  распространенную  книгу
указать рд| что  указанная  им
отвечать тв| отвечающих  всем  этим
ограничен тв| ограничены книгами с  постоянной  нумерацией  страниц
нарушен тв| нарушено неожиданным возгласом  Холмса
потрёпанный тв| потрепанным  томиком в руке
написан дт| им написано
написан рд| им написано
закалён тв| закалены  постоянно  напряженной  работой
удивлён тв| удивлены этим известием
шифровать пр| шифрованном   письме
захватить рд| захватить этого
считать пр| Ярде  считают
держаться тв| особенно  торжественной  манерой  держаться у него
происходить тв| происходило вечером
следовать рд| Этого   следовало  ожидать
создаваться тв| создается незаконными путями
создать рд| созданной  им  цепи
создать дт| созданной  им
опубликован рд| века  и  была опубликована в 1907  году в  журнале "Стрэнд"
пугать вн| пугали долготерпеливую  публику
оплатить тв| оплаченным ответом
застегнуть пр| неправильно застегнутом жилете
глянуть тв| глянул своими бульдожьими глазами  на  нашего посетителя
подождать вн| Подождите минутку,  Грегсон
завязаться тв| молодым человеком  завязалась
хотя тв| хотя потом
заляпать тв| заляпанной  выцветшей дверью
потворствовать дт| потворствует вкусам публики,  вместо того чтобы
изложить вн| изложить эту  историю
заинтересовать вн| заинтересует публику
становиться дт| самому становиться
терпеть вн| терпел  неудачу
предлагать рд| предлагали ничего
молчать тв| большей частью молча
притоптывать тв| притоптывал ногой
вводить вн| вводить  поддельную  муху  в  поддельный  янтарь
забыть вн| забыл здесь свою трубку
перехвачен пр| местах  перехвачено
разглядывать дт| своему  ее  разглядывает
наводить вн| наводить экономию
разжигать вн| разжигая  трубку
поднести вн| поднесете трубку к огню
выслушать пр| другом  выслушали  в  этой  комнате  немало странных  тайн
внести рд| счастье  внести  мир
исполнить вн| исполнить эту  просьбу
стиснуть тв| стиснутым  кулаком
отметать вн| отметая прочь всю сдержанность
мести вн| что метет  улицу перед нашим домом
снимать дт| снимаем виллу в Норбери
возбуждён тв| возбужден  своим  маленьким  приключением
озарить тв| озаренное свечой
потереть тв| потер кулаком о железный край
говорить вн| говорит неправду
уткнуться тв| уткнулся лицом в стенку с чувством дурноты
найти рд1| найду покоя
строить вн| строя  догадку  за  догадкой
побелеть тв| побелевшим  лицом
ходить тв| ходила ночью
перепугать тв| перепуганным лицом
омрачать вн| что  омрачало мою жизнь
свернуться тв| свернувшись клубком
разгореться тв| разгорелись  яростным,  злым  огнем
сняться дт| настоянию снялась
подарить вн| подарила  свою фотографию
надломить тв| надломленным  голосом
исчезать тв| рывком исчезало
догадываться дт| признакам догадывается
предпринимать вн| предпринимает  новую попытку
найти тв| сегодня  найдет  его пустым
обсадить тв| обсаженной деревьями
вломиться тв| силой вломлюсь в дом
раскрывать вн| раскрывать ее тайну
сворачивать пр| месте сворачивал
думать рд| думай  ничего
заступить дт| заступить ему
схватиться тв| схватившись  рукой за горло
нажать вн| нажала пружину
отскочить рд| медальона отскочила
зарыться тв| зарылась личиком
привезти вн| девочку привезли сюда
сходить рд| сходила с ума от страха
обязать тв| этим обяжете
спускаться пр| покато  спускается  поле
отплыть пр2| своей  жизни  и тринадцатом году правления отплыл в  Грецию  в  самом  странном  сопровождении
встречать тв| встречать  единодушным  восторгом
исполнять вн| исполнял  свою,  особую  роль
топать тв| топали ногами
колотить тв| колотили палками по скамьям
